Name	Layer	ClipPath	RootMotionPath
Drama_Foundation_01_End	BaseLayer	Assets/Product/Role/DlcAnimation/BigWorld/Common/R4LiangMdCommonSG/R4LiangMdCommonSG/CommonLayer/Drama_Foundation_01_End.anim	Assets/Product/Role/DlcAnimation/BigWorld/Common/R4LiangMdCommonSG/R4LiangMdCommonSG/CommonLayer/Drama_Foundation_01_End.asset
Drama_Foundation_01_Loop	BaseLayer	Assets/Product/Role/DlcAnimation/BigWorld/Common/R4LiangMdCommonSG/R4LiangMdCommonSG/CommonLayer/Drama_Foundation_01_Loop.anim	Assets/Product/Role/DlcAnimation/BigWorld/Common/R4LiangMdCommonSG/R4LiangMdCommonSG/CommonLayer/Drama_Foundation_01_Loop.asset
Drama_Foundation_01_Start	BaseLayer	Assets/Product/Role/DlcAnimation/BigWorld/Common/R4LiangMdCommonSG/R4LiangMdCommonSG/CommonLayer/Drama_Foundation_01_Start.anim	Assets/Product/Role/DlcAnimation/BigWorld/Common/R4LiangMdCommonSG/R4LiangMdCommonSG/CommonLayer/Drama_Foundation_01_Start.asset
Drama_Foundation_02_End	BaseLayer	Assets/Product/Role/DlcAnimation/BigWorld/Common/R4LiangMdCommonSG/R4LiangMdCommonSG/CommonLayer/Drama_Foundation_02_End.anim	Assets/Product/Role/DlcAnimation/BigWorld/Common/R4LiangMdCommonSG/R4LiangMdCommonSG/CommonLayer/Drama_Foundation_02_End.asset
Drama_Foundation_02_Loop	BaseLayer	Assets/Product/Role/DlcAnimation/BigWorld/Common/R4LiangMdCommonSG/R4LiangMdCommonSG/CommonLayer/Drama_Foundation_02_Loop.anim	Assets/Product/Role/DlcAnimation/BigWorld/Common/R4LiangMdCommonSG/R4LiangMdCommonSG/CommonLayer/Drama_Foundation_02_Loop.asset
Drama_Foundation_02_Start	BaseLayer	Assets/Product/Role/DlcAnimation/BigWorld/Common/R4LiangMdCommonSG/R4LiangMdCommonSG/CommonLayer/Drama_Foundation_02_Start.anim	Assets/Product/Role/DlcAnimation/BigWorld/Common/R4LiangMdCommonSG/R4LiangMdCommonSG/CommonLayer/Drama_Foundation_02_Start.asset
Drama_Stand_01	BaseLayer	Assets/Product/Role/DlcAnimation/BigWorld/Common/R4LiangMdCommonSG/R4LiangMdCommonSG/CommonLayer/Drama_Stand_01.anim	Assets/Product/Role/DlcAnimation/BigWorld/Common/R4LiangMdCommonSG/R4LiangMdCommonSG/CommonLayer/Drama_Stand_01.asset
Drama_Stand_02_End	BaseLayer	Assets/Product/Role/DlcAnimation/BigWorld/Common/R4LiangMdCommonSG/R4LiangMdCommonSG/CommonLayer/Drama_Stand_02_End.anim	Assets/Product/Role/DlcAnimation/BigWorld/Common/R4LiangMdCommonSG/R4LiangMdCommonSG/CommonLayer/Drama_Stand_02_End.asset
Drama_Stand_02_Loop	BaseLayer	Assets/Product/Role/DlcAnimation/BigWorld/Common/R4LiangMdCommonSG/R4LiangMdCommonSG/CommonLayer/Drama_Stand_02_Loop.anim	Assets/Product/Role/DlcAnimation/BigWorld/Common/R4LiangMdCommonSG/R4LiangMdCommonSG/CommonLayer/Drama_Stand_02_Loop.asset
Drama_Stand_02_Start	BaseLayer	Assets/Product/Role/DlcAnimation/BigWorld/Common/R4LiangMdCommonSG/R4LiangMdCommonSG/CommonLayer/Drama_Stand_02_Start.anim	Assets/Product/Role/DlcAnimation/BigWorld/Common/R4LiangMdCommonSG/R4LiangMdCommonSG/CommonLayer/Drama_Stand_02_Start.asset
Drama_Stand_03_End	BaseLayer	Assets/Product/Role/DlcAnimation/BigWorld/Common/R4LiangMdCommonSG/R4LiangMdCommonSG/CommonLayer/Drama_Stand_03_End.anim	Assets/Product/Role/DlcAnimation/BigWorld/Common/R4LiangMdCommonSG/R4LiangMdCommonSG/CommonLayer/Drama_Stand_03_End.asset
Drama_Stand_03_Loop	BaseLayer	Assets/Product/Role/DlcAnimation/BigWorld/Common/R4LiangMdCommonSG/R4LiangMdCommonSG/CommonLayer/Drama_Stand_03_Loop.anim	Assets/Product/Role/DlcAnimation/BigWorld/Common/R4LiangMdCommonSG/R4LiangMdCommonSG/CommonLayer/Drama_Stand_03_Loop.asset
Drama_Stand_03_Start	BaseLayer	Assets/Product/Role/DlcAnimation/BigWorld/Common/R4LiangMdCommonSG/R4LiangMdCommonSG/CommonLayer/Drama_Stand_03_Start.anim	Assets/Product/Role/DlcAnimation/BigWorld/Common/R4LiangMdCommonSG/R4LiangMdCommonSG/CommonLayer/Drama_Stand_03_Start.asset
Drama_Stand_04_End	BaseLayer	Assets/Product/Role/DlcAnimation/BigWorld/Common/R4LiangMdCommonSG/R4LiangMdCommonSG/CommonLayer/Drama_Stand_04_End.anim	Assets/Product/Role/DlcAnimation/BigWorld/Common/R4LiangMdCommonSG/R4LiangMdCommonSG/CommonLayer/Drama_Stand_04_End.asset
Drama_Stand_04_Loop	BaseLayer	Assets/Product/Role/DlcAnimation/BigWorld/Common/R4LiangMdCommonSG/R4LiangMdCommonSG/CommonLayer/Drama_Stand_04_Loop.anim	Assets/Product/Role/DlcAnimation/BigWorld/Common/R4LiangMdCommonSG/R4LiangMdCommonSG/CommonLayer/Drama_Stand_04_Loop.asset
Drama_Stand_04_Start	BaseLayer	Assets/Product/Role/DlcAnimation/BigWorld/Common/R4LiangMdCommonSG/R4LiangMdCommonSG/CommonLayer/Drama_Stand_04_Start.anim	Assets/Product/Role/DlcAnimation/BigWorld/Common/R4LiangMdCommonSG/R4LiangMdCommonSG/CommonLayer/Drama_Stand_04_Start.asset
Drama_Stand_05_End	BaseLayer	Assets/Product/Role/DlcAnimation/BigWorld/Common/R4LiangMdCommonSG/R4LiangMdCommonSG/CommonLayer/Drama_Stand_05_End.anim	Assets/Product/Role/DlcAnimation/BigWorld/Common/R4LiangMdCommonSG/R4LiangMdCommonSG/CommonLayer/Drama_Stand_05_End.asset
Drama_Stand_05_Loop	BaseLayer	Assets/Product/Role/DlcAnimation/BigWorld/Common/R4LiangMdCommonSG/R4LiangMdCommonSG/CommonLayer/Drama_Stand_05_Loop.anim	Assets/Product/Role/DlcAnimation/BigWorld/Common/R4LiangMdCommonSG/R4LiangMdCommonSG/CommonLayer/Drama_Stand_05_Loop.asset
Drama_Stand_05_Start	BaseLayer	Assets/Product/Role/DlcAnimation/BigWorld/Common/R4LiangMdCommonSG/R4LiangMdCommonSG/CommonLayer/Drama_Stand_05_Start.anim	Assets/Product/Role/DlcAnimation/BigWorld/Common/R4LiangMdCommonSG/R4LiangMdCommonSG/CommonLayer/Drama_Stand_05_Start.asset
Drama_Stand_06_End	BaseLayer	Assets/Product/Role/DlcAnimation/BigWorld/Common/R4LiangMdCommonSG/R4LiangMdCommonSG/CommonLayer/Drama_Stand_06_End.anim	Assets/Product/Role/DlcAnimation/BigWorld/Common/R4LiangMdCommonSG/R4LiangMdCommonSG/CommonLayer/Drama_Stand_06_End.asset
Drama_Stand_06_Loop	BaseLayer	Assets/Product/Role/DlcAnimation/BigWorld/Common/R4LiangMdCommonSG/R4LiangMdCommonSG/CommonLayer/Drama_Stand_06_Loop.anim	Assets/Product/Role/DlcAnimation/BigWorld/Common/R4LiangMdCommonSG/R4LiangMdCommonSG/CommonLayer/Drama_Stand_06_Loop.asset
Drama_Stand_06_Start	BaseLayer	Assets/Product/Role/DlcAnimation/BigWorld/Common/R4LiangMdCommonSG/R4LiangMdCommonSG/CommonLayer/Drama_Stand_06_Start.anim	Assets/Product/Role/DlcAnimation/BigWorld/Common/R4LiangMdCommonSG/R4LiangMdCommonSG/CommonLayer/Drama_Stand_06_Start.asset
Drama_Stand_07_End	BaseLayer	Assets/Product/Role/DlcAnimation/BigWorld/Common/R4LiangMdCommonSG/R4LiangMdCommonSG/CommonLayer/Drama_Stand_07_End.anim	Assets/Product/Role/DlcAnimation/BigWorld/Common/R4LiangMdCommonSG/R4LiangMdCommonSG/CommonLayer/Drama_Stand_07_End.asset
Drama_Stand_07_Loop	BaseLayer	Assets/Product/Role/DlcAnimation/BigWorld/Common/R4LiangMdCommonSG/R4LiangMdCommonSG/CommonLayer/Drama_Stand_07_Loop.anim	Assets/Product/Role/DlcAnimation/BigWorld/Common/R4LiangMdCommonSG/R4LiangMdCommonSG/CommonLayer/Drama_Stand_07_Loop.asset
Drama_Stand_07_Start	BaseLayer	Assets/Product/Role/DlcAnimation/BigWorld/Common/R4LiangMdCommonSG/R4LiangMdCommonSG/CommonLayer/Drama_Stand_07_Start.anim	Assets/Product/Role/DlcAnimation/BigWorld/Common/R4LiangMdCommonSG/R4LiangMdCommonSG/CommonLayer/Drama_Stand_07_Start.asset
Drama_Stand_08_End	BaseLayer	Assets/Product/Role/DlcAnimation/BigWorld/Common/R4LiangMdCommonSG/R4LiangMdCommonSG/CommonLayer/Drama_Stand_08_End.anim	Assets/Product/Role/DlcAnimation/BigWorld/Common/R4LiangMdCommonSG/R4LiangMdCommonSG/CommonLayer/Drama_Stand_08_End.asset
Drama_Stand_08_Loop	BaseLayer	Assets/Product/Role/DlcAnimation/BigWorld/Common/R4LiangMdCommonSG/R4LiangMdCommonSG/CommonLayer/Drama_Stand_08_Loop.anim	Assets/Product/Role/DlcAnimation/BigWorld/Common/R4LiangMdCommonSG/R4LiangMdCommonSG/CommonLayer/Drama_Stand_08_Loop.asset
Drama_Stand_08_Start	BaseLayer	Assets/Product/Role/DlcAnimation/BigWorld/Common/R4LiangMdCommonSG/R4LiangMdCommonSG/CommonLayer/Drama_Stand_08_Start.anim	Assets/Product/Role/DlcAnimation/BigWorld/Common/R4LiangMdCommonSG/R4LiangMdCommonSG/CommonLayer/Drama_Stand_08_Start.asset
Drama_Stand_10	BaseLayer	Assets/Product/Role/DlcAnimation/BigWorld/Common/R4LiangMdCommonSG/R4LiangMdCommonSG/CommonLayer/Drama_Stand_10.anim	Assets/Product/Role/DlcAnimation/BigWorld/Common/R4LiangMdCommonSG/R4LiangMdCommonSG/CommonLayer/Drama_Stand_10.asset
Drama_Stand_11_End	BaseLayer	Assets/Product/Role/DlcAnimation/BigWorld/Common/R4LiangMdCommonSG/R4LiangMdCommonSG/CommonLayer/Drama_Stand_11_End.anim	Assets/Product/Role/DlcAnimation/BigWorld/Common/R4LiangMdCommonSG/R4LiangMdCommonSG/CommonLayer/Drama_Stand_11_End.asset
Drama_Stand_11_Loop	BaseLayer	Assets/Product/Role/DlcAnimation/BigWorld/Common/R4LiangMdCommonSG/R4LiangMdCommonSG/CommonLayer/Drama_Stand_11_Loop.anim	Assets/Product/Role/DlcAnimation/BigWorld/Common/R4LiangMdCommonSG/R4LiangMdCommonSG/CommonLayer/Drama_Stand_11_Loop.asset
Drama_Stand_11_Start	BaseLayer	Assets/Product/Role/DlcAnimation/BigWorld/Common/R4LiangMdCommonSG/R4LiangMdCommonSG/CommonLayer/Drama_Stand_11_Start.anim	Assets/Product/Role/DlcAnimation/BigWorld/Common/R4LiangMdCommonSG/R4LiangMdCommonSG/CommonLayer/Drama_Stand_11_Start.asset
Drama_Stand_12_End	BaseLayer	Assets/Product/Role/DlcAnimation/BigWorld/Common/R4LiangMdCommonSG/R4LiangMdCommonSG/CommonLayer/Drama_Stand_12_End.anim	Assets/Product/Role/DlcAnimation/BigWorld/Common/R4LiangMdCommonSG/R4LiangMdCommonSG/CommonLayer/Drama_Stand_12_End.asset
Drama_Stand_12_Loop	BaseLayer	Assets/Product/Role/DlcAnimation/BigWorld/Common/R4LiangMdCommonSG/R4LiangMdCommonSG/CommonLayer/Drama_Stand_12_Loop.anim	Assets/Product/Role/DlcAnimation/BigWorld/Common/R4LiangMdCommonSG/R4LiangMdCommonSG/CommonLayer/Drama_Stand_12_Loop.asset
Drama_Stand_12_Start	BaseLayer	Assets/Product/Role/DlcAnimation/BigWorld/Common/R4LiangMdCommonSG/R4LiangMdCommonSG/CommonLayer/Drama_Stand_12_Start.anim	Assets/Product/Role/DlcAnimation/BigWorld/Common/R4LiangMdCommonSG/R4LiangMdCommonSG/CommonLayer/Drama_Stand_12_Start.asset
Drama_Stand_9	BaseLayer	Assets/Product/Role/DlcAnimation/BigWorld/Common/R4LiangMdCommonSG/R4LiangMdCommonSG/CommonLayer/Drama_Stand_9.anim	Assets/Product/Role/DlcAnimation/BigWorld/Common/R4LiangMdCommonSG/R4LiangMdCommonSG/CommonLayer/Drama_Stand_9.asset
Jumpchange1	BaseLayer	Assets/Product/Role/DlcAnimation/BigWorld/Common/R4LiangMdCommonSG/R4LiangMdCommonSG/CommonLayer/Jumpchange1.anim	
Jumpchange2	BaseLayer	Assets/Product/Role/DlcAnimation/BigWorld/Common/R4LiangMdCommonSG/R4LiangMdCommonSG/CommonLayer/Jumpchange2.anim	
Jumpdown1	BaseLayer	Assets/Product/Role/DlcAnimation/BigWorld/Common/R4LiangMdCommonSG/R4LiangMdCommonSG/CommonLayer/Jumpdown1.anim	
Jumpdown11	BaseLayer	Assets/Product/Role/DlcAnimation/BigWorld/Common/R4LiangMdCommonSG/R4LiangMdCommonSG/CommonLayer/Jumpdown11.anim	Assets/Product/Role/DlcAnimation/BigWorld/Common/R4LiangMdCommonSG/R4LiangMdCommonSG/CommonLayer/Jumpdown11.asset
Jumpdown2	BaseLayer	Assets/Product/Role/DlcAnimation/BigWorld/Common/R4LiangMdCommonSG/R4LiangMdCommonSG/CommonLayer/Jumpdown2.anim	Assets/Product/Role/DlcAnimation/BigWorld/Common/R4LiangMdCommonSG/R4LiangMdCommonSG/CommonLayer/Jumpdown2.asset
Jumpdown21	BaseLayer	Assets/Product/Role/DlcAnimation/BigWorld/Common/R4LiangMdCommonSG/R4LiangMdCommonSG/CommonLayer/Jumpdown21.anim	Assets/Product/Role/DlcAnimation/BigWorld/Common/R4LiangMdCommonSG/R4LiangMdCommonSG/CommonLayer/Jumpdown21.asset
Jumpfall1	BaseLayer	Assets/Product/Role/DlcAnimation/BigWorld/Common/R4LiangMdCommonSG/R4LiangMdCommonSG/CommonLayer/Jumpfall1.anim	
Jumpfall2	BaseLayer	Assets/Product/Role/DlcAnimation/BigWorld/Common/R4LiangMdCommonSG/R4LiangMdCommonSG/CommonLayer/Jumpfall2.anim	
Jumpfalling1	BaseLayer	Assets/Product/Role/DlcAnimation/BigWorld/Common/R4LiangMdCommonSG/R4LiangMdCommonSG/CommonLayer/Jumpfalling1.anim	Assets/Product/Role/DlcAnimation/BigWorld/Common/R4LiangMdCommonSG/R4LiangMdCommonSG/CommonLayer/Jumpfalling1.asset
Jumpfalling2	BaseLayer	Assets/Product/Role/DlcAnimation/BigWorld/Common/R4LiangMdCommonSG/R4LiangMdCommonSG/CommonLayer/Jumpfalling2.anim	Assets/Product/Role/DlcAnimation/BigWorld/Common/R4LiangMdCommonSG/R4LiangMdCommonSG/CommonLayer/Jumpfalling2.asset
Jumprise1	BaseLayer	Assets/Product/Role/DlcAnimation/BigWorld/Common/R4LiangMdCommonSG/R4LiangMdCommonSG/CommonLayer/Jumprise1.anim	
Jumprise2	BaseLayer	Assets/Product/Role/DlcAnimation/BigWorld/Common/R4LiangMdCommonSG/R4LiangMdCommonSG/CommonLayer/Jumprise2.anim	
Jumpsquat1	BaseLayer	Assets/Product/Role/DlcAnimation/BigWorld/Common/R4LiangMdCommonSG/R4LiangMdCommonSG/CommonLayer/Jumpsquat1.anim	
Jumpsquat2	BaseLayer	Assets/Product/Role/DlcAnimation/BigWorld/Common/R4LiangMdCommonSG/R4LiangMdCommonSG/CommonLayer/Jumpsquat2.anim	Assets/Product/Role/DlcAnimation/BigWorld/Common/R4LiangMdCommonSG/R4LiangMdCommonSG/CommonLayer/Jumpsquat2.asset
Run	BaseLayer	Assets/Product/Role/DlcAnimation/BigWorld/Common/R4LiangMdCommonSG/R4LiangMdCommonSG/CommonLayer/Run.anim	Assets/Product/Role/DlcAnimation/BigWorld/Common/R4LiangMdCommonSG/R4LiangMdCommonSG/CommonLayer/Run.asset
RunLeanL	BaseLayer	Assets/Product/Role/DlcAnimation/BigWorld/Common/R4LiangMdCommonSG/R4LiangMdCommonSG/CommonLayer/RunLeanL.anim	Assets/Product/Role/DlcAnimation/BigWorld/Common/R4LiangMdCommonSG/R4LiangMdCommonSG/CommonLayer/RunLeanL.asset
RunLeanR	BaseLayer	Assets/Product/Role/DlcAnimation/BigWorld/Common/R4LiangMdCommonSG/R4LiangMdCommonSG/CommonLayer/RunLeanR.anim	Assets/Product/Role/DlcAnimation/BigWorld/Common/R4LiangMdCommonSG/R4LiangMdCommonSG/CommonLayer/RunLeanR.asset
RunStart	BaseLayer	Assets/Product/Role/DlcAnimation/BigWorld/Common/R4LiangMdCommonSG/R4LiangMdCommonSG/CommonLayer/RunStart.anim	Assets/Product/Role/DlcAnimation/BigWorld/Common/R4LiangMdCommonSG/R4LiangMdCommonSG/CommonLayer/RunStart.asset
RunStartEnd01	BaseLayer	Assets/Product/Role/DlcAnimation/BigWorld/Common/R4LiangMdCommonSG/R4LiangMdCommonSG/CommonLayer/RunStartEnd01.anim	Assets/Product/Role/DlcAnimation/BigWorld/Common/R4LiangMdCommonSG/R4LiangMdCommonSG/CommonLayer/RunStartEnd01.asset
Sit01_Loop	BaseLayer	Assets/Product/Role/DlcAnimation/BigWorld/Common/R4LiangMdCommonSG/R4LiangMdCommonSG/CommonLayer/Sit01_Loop.anim	Assets/Product/Role/DlcAnimation/BigWorld/Common/R4LiangMdCommonSG/R4LiangMdCommonSG/CommonLayer/Sit01_Loop.asset
Sit_Disposable	BaseLayer	Assets/Product/Role/DlcAnimation/BigWorld/Common/R4LiangMdCommonSG/R4LiangMdCommonSG/CommonLayer/Sit_Disposable.anim	Assets/Product/Role/DlcAnimation/BigWorld/Common/R4LiangMdCommonSG/R4LiangMdCommonSG/CommonLayer/Sit_Disposable.asset
Sprint	BaseLayer	Assets/Product/Role/DlcAnimation/BigWorld/Common/R4LiangMdCommonSG/R4LiangMdCommonSG/CommonLayer/Sprint.anim	Assets/Product/Role/DlcAnimation/BigWorld/Common/R4LiangMdCommonSG/R4LiangMdCommonSG/CommonLayer/Sprint.asset
SprintLeanL	BaseLayer	Assets/Product/Role/DlcAnimation/BigWorld/Common/R4LiangMdCommonSG/R4LiangMdCommonSG/CommonLayer/SprintLeanL.anim	Assets/Product/Role/DlcAnimation/BigWorld/Common/R4LiangMdCommonSG/R4LiangMdCommonSG/CommonLayer/SprintLeanL.asset
SprintLeanR	BaseLayer	Assets/Product/Role/DlcAnimation/BigWorld/Common/R4LiangMdCommonSG/R4LiangMdCommonSG/CommonLayer/SprintLeanR.anim	Assets/Product/Role/DlcAnimation/BigWorld/Common/R4LiangMdCommonSG/R4LiangMdCommonSG/CommonLayer/SprintLeanR.asset
SprintStop	BaseLayer	Assets/Product/Role/DlcAnimation/BigWorld/Common/R4LiangMdCommonSG/R4LiangMdCommonSG/CommonLayer/SprintStop.anim	Assets/Product/Role/DlcAnimation/BigWorld/Common/R4LiangMdCommonSG/R4LiangMdCommonSG/CommonLayer/SprintStop.asset
Stand2	BaseLayer	Assets/Product/Role/DlcAnimation/BigWorld/Common/R4LiangMdCommonSG/R4LiangMdCommonSG/CommonLayer/Stand2.anim	Assets/Product/Role/DlcAnimation/BigWorld/Common/R4LiangMdCommonSG/R4LiangMdCommonSG/CommonLayer/Stand2.asset
Stop	BaseLayer	Assets/Product/Role/DlcAnimation/BigWorld/Common/R4LiangMdCommonSG/R4LiangMdCommonSG/CommonLayer/Stop.anim	Assets/Product/Role/DlcAnimation/BigWorld/Common/R4LiangMdCommonSG/R4LiangMdCommonSG/CommonLayer/Stop.asset
Turn90L	BaseLayer	Assets/Product/Role/DlcAnimation/BigWorld/Common/R4LiangMdCommonSG/R4LiangMdCommonSG/CommonLayer/Turn90L.anim	Assets/Product/Role/DlcAnimation/BigWorld/Common/R4LiangMdCommonSG/R4LiangMdCommonSG/CommonLayer/Turn90L.asset
Turn90R	BaseLayer	Assets/Product/Role/DlcAnimation/BigWorld/Common/R4LiangMdCommonSG/R4LiangMdCommonSG/CommonLayer/Turn90R.anim	Assets/Product/Role/DlcAnimation/BigWorld/Common/R4LiangMdCommonSG/R4LiangMdCommonSG/CommonLayer/Turn90R.asset
UiBabyLoniaFace3dStand	BaseLayer	Assets/Product/Role/DlcAnimation/BigWorld/Common/R4LiangMdCommonSG/R4LiangMdCommonSG/CommonLayer/UiBabyLoniaFace3dStand.anim	Assets/Product/Role/DlcAnimation/BigWorld/Common/R4LiangMdCommonSG/R4LiangMdCommonSG/CommonLayer/UiBabyLoniaFace3dStand.asset
Walk	BaseLayer	Assets/Product/Role/DlcAnimation/BigWorld/Common/R4LiangMdCommonSG/R4LiangMdCommonSG/CommonLayer/Walk.anim	Assets/Product/Role/DlcAnimation/BigWorld/Common/R4LiangMdCommonSG/R4LiangMdCommonSG/CommonLayer/Walk.asset
WalkEnd	BaseLayer	Assets/Product/Role/DlcAnimation/BigWorld/Common/R4LiangMdCommonSG/R4LiangMdCommonSG/CommonLayer/WalkEnd.anim	Assets/Product/Role/DlcAnimation/BigWorld/Common/R4LiangMdCommonSG/R4LiangMdCommonSG/CommonLayer/WalkEnd.asset
WalkStart	BaseLayer	Assets/Product/Role/DlcAnimation/BigWorld/Common/R4LiangMdCommonSG/R4LiangMdCommonSG/CommonLayer/WalkStart.anim	Assets/Product/Role/DlcAnimation/BigWorld/Common/R4LiangMdCommonSG/R4LiangMdCommonSG/CommonLayer/WalkStart.asset
Drama_Special_05_End	FaceLayer	Assets/Product/Role/DlcAnimation/BigWorld/Common/R4LiangMdCommonSG/R4LiangMdCommonSG/FaceLayer/Drama_Special_05_End.anim	
Drama_Special_05_Loop	FaceLayer	Assets/Product/Role/DlcAnimation/BigWorld/Common/R4LiangMdCommonSG/R4LiangMdCommonSG/FaceLayer/Drama_Special_05_Loop.anim	
Drama_Special_05_Start	FaceLayer	Assets/Product/Role/DlcAnimation/BigWorld/Common/R4LiangMdCommonSG/R4LiangMdCommonSG/FaceLayer/Drama_Special_05_Start.anim	
Drama_Special_06_End	FaceLayer	Assets/Product/Role/DlcAnimation/BigWorld/Common/R4LiangMdCommonSG/R4LiangMdCommonSG/FaceLayer/Drama_Special_06_End.anim	
Drama_Special_06_Loop	FaceLayer	Assets/Product/Role/DlcAnimation/BigWorld/Common/R4LiangMdCommonSG/R4LiangMdCommonSG/FaceLayer/Drama_Special_06_Loop.anim	
Drama_Special_06_Start	FaceLayer	Assets/Product/Role/DlcAnimation/BigWorld/Common/R4LiangMdCommonSG/R4LiangMdCommonSG/FaceLayer/Drama_Special_06_Start.anim	
Drama_Special_07_End	FaceLayer	Assets/Product/Role/DlcAnimation/BigWorld/Common/R4LiangMdCommonSG/R4LiangMdCommonSG/FaceLayer/Drama_Special_07_End.anim	
Drama_Special_07_Loop	FaceLayer	Assets/Product/Role/DlcAnimation/BigWorld/Common/R4LiangMdCommonSG/R4LiangMdCommonSG/FaceLayer/Drama_Special_07_Loop.anim	
Drama_Special_07_Start	FaceLayer	Assets/Product/Role/DlcAnimation/BigWorld/Common/R4LiangMdCommonSG/R4LiangMdCommonSG/FaceLayer/Drama_Special_07_Start.anim	
Drama_Special_08_End	FaceLayer	Assets/Product/Role/DlcAnimation/BigWorld/Common/R4LiangMdCommonSG/R4LiangMdCommonSG/FaceLayer/Drama_Special_08_End.anim	
Drama_Special_08_Loop	FaceLayer	Assets/Product/Role/DlcAnimation/BigWorld/Common/R4LiangMdCommonSG/R4LiangMdCommonSG/FaceLayer/Drama_Special_08_Loop.anim	
Drama_Special_08_Start	FaceLayer	Assets/Product/Role/DlcAnimation/BigWorld/Common/R4LiangMdCommonSG/R4LiangMdCommonSG/FaceLayer/Drama_Special_08_Start.anim	
Drama_Special_09_End	FaceLayer	Assets/Product/Role/DlcAnimation/BigWorld/Common/R4LiangMdCommonSG/R4LiangMdCommonSG/FaceLayer/Drama_Special_09_End.anim	
Drama_Special_09_Loop	FaceLayer	Assets/Product/Role/DlcAnimation/BigWorld/Common/R4LiangMdCommonSG/R4LiangMdCommonSG/FaceLayer/Drama_Special_09_Loop.anim	
Drama_Special_09_Start	FaceLayer	Assets/Product/Role/DlcAnimation/BigWorld/Common/R4LiangMdCommonSG/R4LiangMdCommonSG/FaceLayer/Drama_Special_09_Start.anim	
Drama_Special_10_End	FaceLayer	Assets/Product/Role/DlcAnimation/BigWorld/Common/R4LiangMdCommonSG/R4LiangMdCommonSG/FaceLayer/Drama_Special_10_End.anim	
Drama_Special_10_Loop	FaceLayer	Assets/Product/Role/DlcAnimation/BigWorld/Common/R4LiangMdCommonSG/R4LiangMdCommonSG/FaceLayer/Drama_Special_10_Loop.anim	
Drama_Special_10_Start	FaceLayer	Assets/Product/Role/DlcAnimation/BigWorld/Common/R4LiangMdCommonSG/R4LiangMdCommonSG/FaceLayer/Drama_Special_10_Start.anim	
Drama_Special_11_End	FaceLayer	Assets/Product/Role/DlcAnimation/BigWorld/Common/R4LiangMdCommonSG/R4LiangMdCommonSG/FaceLayer/Drama_Special_11_End.anim	
Drama_Special_11_Loop	FaceLayer	Assets/Product/Role/DlcAnimation/BigWorld/Common/R4LiangMdCommonSG/R4LiangMdCommonSG/FaceLayer/Drama_Special_11_Loop.anim	
Drama_Special_11_Start	FaceLayer	Assets/Product/Role/DlcAnimation/BigWorld/Common/R4LiangMdCommonSG/R4LiangMdCommonSG/FaceLayer/Drama_Special_11_Start.anim	
Drama_Special_12_End	FaceLayer	Assets/Product/Role/DlcAnimation/BigWorld/Common/R4LiangMdCommonSG/R4LiangMdCommonSG/FaceLayer/Drama_Special_12_End.anim	
Drama_Special_12_Loop	FaceLayer	Assets/Product/Role/DlcAnimation/BigWorld/Common/R4LiangMdCommonSG/R4LiangMdCommonSG/FaceLayer/Drama_Special_12_Loop.anim	
Drama_Special_12_Start	FaceLayer	Assets/Product/Role/DlcAnimation/BigWorld/Common/R4LiangMdCommonSG/R4LiangMdCommonSG/FaceLayer/Drama_Special_12_Start.anim	
Drama_Special_13_End	FaceLayer	Assets/Product/Role/DlcAnimation/BigWorld/Common/R4LiangMdCommonSG/R4LiangMdCommonSG/FaceLayer/Drama_Special_13_End.anim	
Drama_Special_13_Loop	FaceLayer	Assets/Product/Role/DlcAnimation/BigWorld/Common/R4LiangMdCommonSG/R4LiangMdCommonSG/FaceLayer/Drama_Special_13_Loop.anim	
Drama_Special_13_Start	FaceLayer	Assets/Product/Role/DlcAnimation/BigWorld/Common/R4LiangMdCommonSG/R4LiangMdCommonSG/FaceLayer/Drama_Special_13_Start.anim	
Drama_Special_14_End	FaceLayer	Assets/Product/Role/DlcAnimation/BigWorld/Common/R4LiangMdCommonSG/R4LiangMdCommonSG/FaceLayer/Drama_Special_14_End.anim	
Drama_Special_14_Loop	FaceLayer	Assets/Product/Role/DlcAnimation/BigWorld/Common/R4LiangMdCommonSG/R4LiangMdCommonSG/FaceLayer/Drama_Special_14_Loop.anim	
Drama_Special_14_Start	FaceLayer	Assets/Product/Role/DlcAnimation/BigWorld/Common/R4LiangMdCommonSG/R4LiangMdCommonSG/FaceLayer/Drama_Special_14_Start.anim	
Drama_Special_15_End	FaceLayer	Assets/Product/Role/DlcAnimation/BigWorld/Common/R4LiangMdCommonSG/R4LiangMdCommonSG/FaceLayer/Drama_Special_15_End.anim	
Drama_Special_15_Loop	FaceLayer	Assets/Product/Role/DlcAnimation/BigWorld/Common/R4LiangMdCommonSG/R4LiangMdCommonSG/FaceLayer/Drama_Special_15_Loop.anim	
Drama_Special_15_Start	FaceLayer	Assets/Product/Role/DlcAnimation/BigWorld/Common/R4LiangMdCommonSG/R4LiangMdCommonSG/FaceLayer/Drama_Special_15_Start.anim	
Drama_Special_16_End	FaceLayer	Assets/Product/Role/DlcAnimation/BigWorld/Common/R4LiangMdCommonSG/R4LiangMdCommonSG/FaceLayer/Drama_Special_16_End.anim	
Drama_Special_16_Loop	FaceLayer	Assets/Product/Role/DlcAnimation/BigWorld/Common/R4LiangMdCommonSG/R4LiangMdCommonSG/FaceLayer/Drama_Special_16_Loop.anim	
Drama_Special_16_Start	FaceLayer	Assets/Product/Role/DlcAnimation/BigWorld/Common/R4LiangMdCommonSG/R4LiangMdCommonSG/FaceLayer/Drama_Special_16_Start.anim	
Drama_Special_Blink_Loop	FaceLayer	Assets/Product/Role/DlcAnimation/BigWorld/Common/R4LiangMdCommonSG/R4LiangMdCommonSG/FaceLayer/Drama_Special_Blink_Loop.anim	
Jump1	BaseLayer	Assets/Product/Role/DlcAnimation/BigWorld/Common/R4LiangMdCommonSG/R4LiangMdCommonSG/CommonLayer/Jump1.anim	Assets/Product/Role/DlcAnimation/BigWorld/Common/R4LiangMdCommonSG/R4LiangMdCommonSG/CommonLayer/Jump1.asset
Jump2	BaseLayer	Assets/Product/Role/DlcAnimation/BigWorld/Common/R4LiangMdCommonSG/R4LiangMdCommonSG/CommonLayer/Jump2.anim	Assets/Product/Role/DlcAnimation/BigWorld/Common/R4LiangMdCommonSG/R4LiangMdCommonSG/CommonLayer/Jump2.asset
RunStartEnd01_L	BaseLayer	Assets/Product/Role/DlcAnimation/BigWorld/Common/R4LiangMdCommonSG/R4LiangMdCommonSG/CommonLayer/RunStartEnd01_L.anim	Assets/Product/Role/DlcAnimation/BigWorld/Common/R4LiangMdCommonSG/R4LiangMdCommonSG/CommonLayer/RunStartEnd01_L.asset
RunStartEnd01_R	BaseLayer	Assets/Product/Role/DlcAnimation/BigWorld/Common/R4LiangMdCommonSG/R4LiangMdCommonSG/CommonLayer/RunStartEnd01_R.anim	Assets/Product/Role/DlcAnimation/BigWorld/Common/R4LiangMdCommonSG/R4LiangMdCommonSG/CommonLayer/RunStartEnd01_R.asset
Stop_Run_L	BaseLayer	Assets/Product/Role/DlcAnimation/BigWorld/Common/R4LiangMdCommonSG/R4LiangMdCommonSG/CommonLayer/Stop_Run_L.anim	Assets/Product/Role/DlcAnimation/BigWorld/Common/R4LiangMdCommonSG/R4LiangMdCommonSG/CommonLayer/Stop_Run_L.asset
Stop_Run_R	BaseLayer	Assets/Product/Role/DlcAnimation/BigWorld/Common/R4LiangMdCommonSG/R4LiangMdCommonSG/CommonLayer/Stop_Run_R.anim	Assets/Product/Role/DlcAnimation/BigWorld/Common/R4LiangMdCommonSG/R4LiangMdCommonSG/CommonLayer/Stop_Run_R.asset
Stop_Sprint_L	BaseLayer	Assets/Product/Role/DlcAnimation/BigWorld/Common/R4LiangMdCommonSG/R4LiangMdCommonSG/CommonLayer/Stop_Sprint_L.anim	Assets/Product/Role/DlcAnimation/BigWorld/Common/R4LiangMdCommonSG/R4LiangMdCommonSG/CommonLayer/Stop_Sprint_L.asset
Stop_Sprint_R	BaseLayer	Assets/Product/Role/DlcAnimation/BigWorld/Common/R4LiangMdCommonSG/R4LiangMdCommonSG/CommonLayer/Stop_Sprint_R.anim	Assets/Product/Role/DlcAnimation/BigWorld/Common/R4LiangMdCommonSG/R4LiangMdCommonSG/CommonLayer/Stop_Sprint_R.asset
Stop_Walk_L	BaseLayer	Assets/Product/Role/DlcAnimation/BigWorld/Common/R4LiangMdCommonSG/R4LiangMdCommonSG/CommonLayer/Stop_Walk_L.anim	Assets/Product/Role/DlcAnimation/BigWorld/Common/R4LiangMdCommonSG/R4LiangMdCommonSG/CommonLayer/Stop_Walk_L.asset
Stop_Walk_R	BaseLayer	Assets/Product/Role/DlcAnimation/BigWorld/Common/R4LiangMdCommonSG/R4LiangMdCommonSG/CommonLayer/Stop_Walk_R.anim	Assets/Product/Role/DlcAnimation/BigWorld/Common/R4LiangMdCommonSG/R4LiangMdCommonSG/CommonLayer/Stop_Walk_R.asset
