Prefab	AssetRefCollection
Assets/Product/BigWorld/SkyGarden_SLNStoryLevel03/StaticPrefabs/MG_Main_L8_X0_Y0.prefab	Assets/Product/AssetRef/BigWorld/SkyGarden_SLNStoryLevel03/StaticPrefabs/MG_Main_L8_X0_Y0.asset
Assets/Product/BigWorld/Standard3C/StaticPrefabs/MG_Main_L0_X128_Y128.prefab	Assets/Product/AssetRef/BigWorld/Standard3C/StaticPrefabs/MG_Main_L0_X128_Y128.asset
Assets/Product/BigWorld/Standard3C/StaticPrefabs/MG_Main_L0_X128_Y129.prefab	Assets/Product/AssetRef/BigWorld/Standard3C/StaticPrefabs/MG_Main_L0_X128_Y129.asset
Assets/Product/BigWorld/Standard3C/StaticPrefabs/MG_Main_L1_X64_Y64.prefab	Assets/Product/AssetRef/BigWorld/Standard3C/StaticPrefabs/MG_Main_L1_X64_Y64.asset
Assets/Product/Effect/DlcPrefab/BigWorld/SkyGarden/Prefab/FxSceneEffect/FxSkyGardenDrama/FxSkyGardenDramaA102Glow.prefab	Assets/Product/AssetRef/Effect/DlcPrefab/BigWorld/SkyGarden/Prefab/FxSceneEffect/FxSkyGardenDrama/FxSkyGardenDramaA102Glow.asset
Assets/Product/Effect/DlcPrefab/BigWorld/SkyGarden/Prefab/FxSceneEffect/FxSkyGardenDrama/FxSkyGardenDramaA102Glow02.prefab	Assets/Product/AssetRef/Effect/DlcPrefab/BigWorld/SkyGarden/Prefab/FxSceneEffect/FxSkyGardenDrama/FxSkyGardenDramaA102Glow02.asset
Assets/Product/Effect/DlcPrefab/BigWorld/SkyGarden/Prefab/FxSceneEffect/FxSkyGardenDrama/FxSkyGardenDramaA123Huaban.prefab	Assets/Product/AssetRef/Effect/DlcPrefab/BigWorld/SkyGarden/Prefab/FxSceneEffect/FxSkyGardenDrama/FxSkyGardenDramaA123Huaban.asset
Assets/Product/Effect/DlcPrefab/BigWorld/SkyGarden/Prefab/FxSceneEffect/FxSkyGardenDrama/FxSkyGardenDramaA123Pingmu.prefab	Assets/Product/AssetRef/Effect/DlcPrefab/BigWorld/SkyGarden/Prefab/FxSceneEffect/FxSkyGardenDrama/FxSkyGardenDramaA123Pingmu.asset
Assets/Product/Effect/DlcPrefab/BigWorld/SkyGarden/Prefab/FxSceneEffect/FxSkyGardenDrama/FxSkyGardenDramaA124Glow.prefab	Assets/Product/AssetRef/Effect/DlcPrefab/BigWorld/SkyGarden/Prefab/FxSceneEffect/FxSkyGardenDrama/FxSkyGardenDramaA124Glow.asset
Assets/Product/Effect/DlcPrefab/BigWorld/SkyGarden/Prefab/FxSceneEffect/FxSkyGardenDrama/FxSkyGardenDramaA124Glow02.prefab	Assets/Product/AssetRef/Effect/DlcPrefab/BigWorld/SkyGarden/Prefab/FxSceneEffect/FxSkyGardenDrama/FxSkyGardenDramaA124Glow02.asset
Assets/Product/Effect/DlcPrefab/BigWorld/SkyGarden/Prefab/FxSceneEffect/FxSkyGardenDrama/FxSkyGardenDramaA124Glow03.prefab	Assets/Product/AssetRef/Effect/DlcPrefab/BigWorld/SkyGarden/Prefab/FxSceneEffect/FxSkyGardenDrama/FxSkyGardenDramaA124Glow03.asset
Assets/Product/Effect/DlcPrefab/BigWorld/SkyGarden/Prefab/FxSceneEffect/FxSkyGardenDrama/FxSkyGardenDramaA124Glow04.prefab	Assets/Product/AssetRef/Effect/DlcPrefab/BigWorld/SkyGarden/Prefab/FxSceneEffect/FxSkyGardenDrama/FxSkyGardenDramaA124Glow04.asset
Assets/Product/Effect/DlcPrefab/BigWorld/SkyGarden/Prefab/FxSceneEffect/FxSkyGardenDrama/FxSkyGardenDramaA124Glow05.prefab	Assets/Product/AssetRef/Effect/DlcPrefab/BigWorld/SkyGarden/Prefab/FxSceneEffect/FxSkyGardenDrama/FxSkyGardenDramaA124Glow05.asset
Assets/Product/Effect/DlcPrefab/BigWorld/SkyGarden/Prefab/FxSceneEffect/FxSkyGardenDrama/FxSkyGardenDramaA124Glow06.prefab	Assets/Product/AssetRef/Effect/DlcPrefab/BigWorld/SkyGarden/Prefab/FxSceneEffect/FxSkyGardenDrama/FxSkyGardenDramaA124Glow06.asset
Assets/Product/Effect/DlcPrefab/BigWorld/SkyGarden/Prefab/FxSceneEffect/FxSkyGardenDrama/FxSkyGardenDramaA124Huaban01.prefab	Assets/Product/AssetRef/Effect/DlcPrefab/BigWorld/SkyGarden/Prefab/FxSceneEffect/FxSkyGardenDrama/FxSkyGardenDramaA124Huaban01.asset
Assets/Product/Effect/DlcPrefab/BigWorld/SkyGarden/Prefab/FxSceneEffect/FxSkyGardenDrama/FxSkyGardenDramaA124Huaban02.prefab	Assets/Product/AssetRef/Effect/DlcPrefab/BigWorld/SkyGarden/Prefab/FxSceneEffect/FxSkyGardenDrama/FxSkyGardenDramaA124Huaban02.asset
Assets/Product/Effect/DlcPrefab/BigWorld/SkyGarden/Prefab/FxSceneEffect/FxSkyGardenDrama/FxSkyGardenDramaA124Huaban03.prefab	Assets/Product/AssetRef/Effect/DlcPrefab/BigWorld/SkyGarden/Prefab/FxSceneEffect/FxSkyGardenDrama/FxSkyGardenDramaA124Huaban03.asset
Assets/Product/Effect/DlcPrefab/BigWorld/SkyGarden/Prefab/FxSceneEffect/FxSkyGardenDrama/FxSkyGardenDramaA146Huaban.prefab	Assets/Product/AssetRef/Effect/DlcPrefab/BigWorld/SkyGarden/Prefab/FxSceneEffect/FxSkyGardenDrama/FxSkyGardenDramaA146Huaban.asset
Assets/Product/Effect/DlcPrefab/BigWorld/SkyGarden/Prefab/FxSceneEffect/FxSkyGardenScene/FxSkyGardenMeteoro01.prefab	Assets/Product/AssetRef/Effect/DlcPrefab/BigWorld/SkyGarden/Prefab/FxSceneEffect/FxSkyGardenScene/FxSkyGardenMeteoro01.asset
Assets/Product/Effect/DlcPrefab/BigWorld/SkyGarden/Prefab/FxSceneEffect/FxSkyGardenTask/FxBigWorldNpcPhone.prefab	Assets/Product/AssetRef/Effect/DlcPrefab/BigWorld/SkyGarden/Prefab/FxSceneEffect/FxSkyGardenTask/FxBigWorldNpcPhone.asset
Assets/Product/Effect/DlcPrefab/BigWorld/SkyGarden/Prefab/FxSceneEffect/FxSkyGardenTask/FxSkyGardenLedHack.prefab	Assets/Product/AssetRef/Effect/DlcPrefab/BigWorld/SkyGarden/Prefab/FxSceneEffect/FxSkyGardenTask/FxSkyGardenLedHack.asset
Assets/Product/BigWorld/Standard3C/StaticPrefabs/Standard3C.prefab	Assets/Product/AssetRef/BigWorld/Standard3C/StaticPrefabs/Standard3C.asset
Assets/Product/BigWorld/SkyGarden/StaticPrefabs/SkyGarden.prefab	Assets/Product/AssetRef/BigWorld/SkyGarden/StaticPrefabs/SkyGarden.asset
Assets/Product/BigWorld/SkyGarden_SuShe/StaticPrefabs/SkyGarden_SuShe.prefab	Assets/Product/AssetRef/BigWorld/SkyGarden_SuShe/StaticPrefabs/SkyGarden_SuShe.asset
Assets/Product/BigWorld/SkyGarden_Plaza/StaticPrefabs/SkyGarden_Plaza.prefab	Assets/Product/AssetRef/BigWorld/SkyGarden_Plaza/StaticPrefabs/SkyGarden_Plaza.asset
Assets/Product/BigWorld/SkyGarden_Plaza_Show/StaticPrefabs/SkyGarden_Plaza_Show.prefab	Assets/Product/AssetRef/BigWorld/SkyGarden_Plaza_Show/StaticPrefabs/SkyGarden_Plaza_Show.asset
Assets/Product/BigWorld/SkyGarden_JumpPlayer/StaticPrefabs/SkyGarden_JumpPlayer.prefab	Assets/Product/AssetRef/BigWorld/SkyGarden_JumpPlayer/StaticPrefabs/SkyGarden_JumpPlayer.asset
Assets/Product/BigWorld/SkyGarden_LxyStoryLevel02/StaticPrefabs/SkyGarden_LxyStoryLevel02.prefab	Assets/Product/AssetRef/BigWorld/SkyGarden_LxyStoryLevel02/StaticPrefabs/SkyGarden_LxyStoryLevel02.asset
Assets/Product/BigWorld/SkyGarden_Scene001/StaticPrefabs/SkyGarden_Scene001.prefab	Assets/Product/AssetRef/BigWorld/SkyGarden_Scene001/StaticPrefabs/SkyGarden_Scene001.asset
Assets/Product/BigWorld/SkyGarden_Scene002/StaticPrefabs/SkyGarden_Scene002.prefab	Assets/Product/AssetRef/BigWorld/SkyGarden_Scene002/StaticPrefabs/SkyGarden_Scene002.asset
Assets/Product/BigWorld/SkyGarden_Scene003/StaticPrefabs/SkyGarden_Scene003.prefab	Assets/Product/AssetRef/BigWorld/SkyGarden_Scene003/StaticPrefabs/SkyGarden_Scene003.asset
Assets/Product/BigWorld/SkyGarden_Scene004/StaticPrefabs/SkyGarden_Scene004.prefab	Assets/Product/AssetRef/BigWorld/SkyGarden_Scene004/StaticPrefabs/SkyGarden_Scene004.asset
Assets/Product/BigWorld/SkyGarden_Scene005/StaticPrefabs/SkyGarden_Scene005.prefab	Assets/Product/AssetRef/BigWorld/SkyGarden_Scene005/StaticPrefabs/SkyGarden_Scene005.asset
Assets/Product/BigWorld/SkyGarden_LxyStoryLevel01/StaticPrefabs/SkyGarden_LxyStoryLevel01.prefab	Assets/Product/AssetRef/BigWorld/SkyGarden_LxyStoryLevel01/StaticPrefabs/SkyGarden_LxyStoryLevel01.asset
Assets/Product/BigWorld/SkyGarden_LxyStoryLevel03/StaticPrefabs/SkyGarden_LxyStoryLevel03.prefab	Assets/Product/AssetRef/BigWorld/SkyGarden_LxyStoryLevel03/StaticPrefabs/SkyGarden_LxyStoryLevel03.asset
Assets/Product/BigWorld/SkyGarden_LxyStoryLevel04/StaticPrefabs/SkyGarden_LxyStoryLevel04.prefab	Assets/Product/AssetRef/BigWorld/SkyGarden_LxyStoryLevel04/StaticPrefabs/SkyGarden_LxyStoryLevel04.asset
Assets/Product/BigWorld/SkyGarden_LxyStoryLevel02/StaticPrefabs/MG_Main_L8_X0_Y0.prefab	Assets/Product/AssetRef/BigWorld/SkyGarden_LxyStoryLevel02/StaticPrefabs/MG_Main_L8_X0_Y0.asset
Assets/Product/BigWorld/SkyGarden_LxyStoryLevel03/StaticPrefabs/MG_Main_L8_X0_Y0.prefab	Assets/Product/AssetRef/BigWorld/SkyGarden_LxyStoryLevel03/StaticPrefabs/MG_Main_L8_X0_Y0.asset
Assets/Product/BigWorld/SkyGarden_LxyStoryLevel04/StaticPrefabs/MG_Main_L8_X0_Y0.prefab	Assets/Product/AssetRef/BigWorld/SkyGarden_LxyStoryLevel04/StaticPrefabs/MG_Main_L8_X0_Y0.asset
Assets/Product/BigWorld/SkyGarden_Plaza/StaticPrefabs/MG_Main_L0_X156_Y142.prefab	Assets/Product/AssetRef/BigWorld/SkyGarden_Plaza/StaticPrefabs/MG_Main_L0_X156_Y142.asset
Assets/Product/BigWorld/SkyGarden_Plaza/StaticPrefabs/MG_Main_L8_X0_Y0.prefab	Assets/Product/AssetRef/BigWorld/SkyGarden_Plaza/StaticPrefabs/MG_Main_L8_X0_Y0.asset
Assets/Product/BigWorld/SkyGarden_Plaza/StaticPrefabs/MG_Building_L7_X0_Y0.prefab	Assets/Product/AssetRef/BigWorld/SkyGarden_Plaza/StaticPrefabs/MG_Building_L7_X0_Y0.asset
Assets/Product/BigWorld/SkyGarden_Plaza/StaticPrefabs/MG_Vegetation_L0_X155_Y142.prefab	Assets/Product/AssetRef/BigWorld/SkyGarden_Plaza/StaticPrefabs/MG_Vegetation_L0_X155_Y142.asset
Assets/Product/BigWorld/SkyGarden_Plaza/StaticPrefabs/MG_Vegetation_L0_X156_Y142.prefab	Assets/Product/AssetRef/BigWorld/SkyGarden_Plaza/StaticPrefabs/MG_Vegetation_L0_X156_Y142.asset
Assets/Product/BigWorld/SkyGarden_Plaza/StaticPrefabs/MG_Vegetation_L0_X155_Y143.prefab	Assets/Product/AssetRef/BigWorld/SkyGarden_Plaza/StaticPrefabs/MG_Vegetation_L0_X155_Y143.asset
Assets/Product/BigWorld/SkyGarden_Plaza/StaticPrefabs/MG_Vegetation_L0_X154_Y143.prefab	Assets/Product/AssetRef/BigWorld/SkyGarden_Plaza/StaticPrefabs/MG_Vegetation_L0_X154_Y143.asset
Assets/Product/BigWorld/SkyGarden_Plaza/StaticPrefabs/MG_Vegetation_L0_X157_Y141.prefab	Assets/Product/AssetRef/BigWorld/SkyGarden_Plaza/StaticPrefabs/MG_Vegetation_L0_X157_Y141.asset
Assets/Product/BigWorld/SkyGarden_Plaza/StaticPrefabs/MG_Vegetation_L0_X156_Y140.prefab	Assets/Product/AssetRef/BigWorld/SkyGarden_Plaza/StaticPrefabs/MG_Vegetation_L0_X156_Y140.asset
Assets/Product/BigWorld/SkyGarden_Plaza/StaticPrefabs/MG_Vegetation_L8_X0_Y0.prefab	Assets/Product/AssetRef/BigWorld/SkyGarden_Plaza/StaticPrefabs/MG_Vegetation_L8_X0_Y0.asset
Assets/Product/BigWorld/SkyGarden_Plaza/StaticPrefabs/MG_Tree_L8_X0_Y0.prefab	Assets/Product/AssetRef/BigWorld/SkyGarden_Plaza/StaticPrefabs/MG_Tree_L8_X0_Y0.asset
Assets/Product/BigWorld/SkyGarden_Plaza/StaticPrefabs/MG_Ground_L7_X0_Y0.prefab	Assets/Product/AssetRef/BigWorld/SkyGarden_Plaza/StaticPrefabs/MG_Ground_L7_X0_Y0.asset
Assets/Product/BigWorld/SkyGarden_Plaza/StaticPrefabs/MG_BuildingMiddle_L7_X0_Y0.prefab	Assets/Product/AssetRef/BigWorld/SkyGarden_Plaza/StaticPrefabs/MG_BuildingMiddle_L7_X0_Y0.asset
Assets/Product/BigWorld/SkyGarden_Plaza_Show/StaticPrefabs/MG_Main_L0_X165_Y145.prefab	Assets/Product/AssetRef/BigWorld/SkyGarden_Plaza_Show/StaticPrefabs/MG_Main_L0_X165_Y145.asset
Assets/Product/BigWorld/SkyGarden_Plaza_Show/StaticPrefabs/MG_Main_L0_X163_Y145.prefab	Assets/Product/AssetRef/BigWorld/SkyGarden_Plaza_Show/StaticPrefabs/MG_Main_L0_X163_Y145.asset
Assets/Product/BigWorld/SkyGarden_Plaza_Show/StaticPrefabs/MG_Main_L0_X166_Y146.prefab	Assets/Product/AssetRef/BigWorld/SkyGarden_Plaza_Show/StaticPrefabs/MG_Main_L0_X166_Y146.asset
Assets/Product/BigWorld/SkyGarden_Plaza_Show/StaticPrefabs/MG_Main_L0_X166_Y147.prefab	Assets/Product/AssetRef/BigWorld/SkyGarden_Plaza_Show/StaticPrefabs/MG_Main_L0_X166_Y147.asset
Assets/Product/BigWorld/SkyGarden_Plaza_Show/StaticPrefabs/MG_Main_L0_X166_Y148.prefab	Assets/Product/AssetRef/BigWorld/SkyGarden_Plaza_Show/StaticPrefabs/MG_Main_L0_X166_Y148.asset
Assets/Product/BigWorld/SkyGarden_Plaza_Show/StaticPrefabs/MG_Main_L0_X163_Y147.prefab	Assets/Product/AssetRef/BigWorld/SkyGarden_Plaza_Show/StaticPrefabs/MG_Main_L0_X163_Y147.asset
Assets/Product/BigWorld/SkyGarden_Plaza_Show/StaticPrefabs/MG_Main_L0_X164_Y147.prefab	Assets/Product/AssetRef/BigWorld/SkyGarden_Plaza_Show/StaticPrefabs/MG_Main_L0_X164_Y147.asset
Assets/Product/BigWorld/SkyGarden_Plaza_Show/StaticPrefabs/MG_Main_L0_X162_Y146.prefab	Assets/Product/AssetRef/BigWorld/SkyGarden_Plaza_Show/StaticPrefabs/MG_Main_L0_X162_Y146.asset
Assets/Product/BigWorld/SkyGarden_Plaza_Show/StaticPrefabs/MG_Main_L0_X161_Y146.prefab	Assets/Product/AssetRef/BigWorld/SkyGarden_Plaza_Show/StaticPrefabs/MG_Main_L0_X161_Y146.asset
Assets/Product/BigWorld/SkyGarden_Plaza_Show/StaticPrefabs/MG_Main_L0_X167_Y149.prefab	Assets/Product/AssetRef/BigWorld/SkyGarden_Plaza_Show/StaticPrefabs/MG_Main_L0_X167_Y149.asset
Assets/Product/BigWorld/SkyGarden_Plaza_Show/StaticPrefabs/MG_Main_L0_X167_Y148.prefab	Assets/Product/AssetRef/BigWorld/SkyGarden_Plaza_Show/StaticPrefabs/MG_Main_L0_X167_Y148.asset
Assets/Product/BigWorld/SkyGarden_Plaza_Show/StaticPrefabs/MG_Main_L0_X164_Y145.prefab	Assets/Product/AssetRef/BigWorld/SkyGarden_Plaza_Show/StaticPrefabs/MG_Main_L0_X164_Y145.asset
Assets/Product/BigWorld/SkyGarden_Plaza_Show/StaticPrefabs/MG_Main_L0_X165_Y147.prefab	Assets/Product/AssetRef/BigWorld/SkyGarden_Plaza_Show/StaticPrefabs/MG_Main_L0_X165_Y147.asset
Assets/Product/BigWorld/SkyGarden_Plaza_Show/StaticPrefabs/MG_Main_L0_X163_Y146.prefab	Assets/Product/AssetRef/BigWorld/SkyGarden_Plaza_Show/StaticPrefabs/MG_Main_L0_X163_Y146.asset
Assets/Product/BigWorld/SkyGarden_Plaza_Show/StaticPrefabs/MG_Main_L0_X165_Y149.prefab	Assets/Product/AssetRef/BigWorld/SkyGarden_Plaza_Show/StaticPrefabs/MG_Main_L0_X165_Y149.asset
Assets/Product/BigWorld/SkyGarden_Plaza_Show/StaticPrefabs/MG_Main_L0_X162_Y148.prefab	Assets/Product/AssetRef/BigWorld/SkyGarden_Plaza_Show/StaticPrefabs/MG_Main_L0_X162_Y148.asset
Assets/Product/BigWorld/SkyGarden_Plaza_Show/StaticPrefabs/MG_Main_L0_X164_Y149.prefab	Assets/Product/AssetRef/BigWorld/SkyGarden_Plaza_Show/StaticPrefabs/MG_Main_L0_X164_Y149.asset
Assets/Product/BigWorld/SkyGarden_Plaza_Show/StaticPrefabs/MG_Main_L0_X168_Y148.prefab	Assets/Product/AssetRef/BigWorld/SkyGarden_Plaza_Show/StaticPrefabs/MG_Main_L0_X168_Y148.asset
Assets/Product/BigWorld/SkyGarden_Plaza_Show/StaticPrefabs/MG_Main_L0_X166_Y149.prefab	Assets/Product/AssetRef/BigWorld/SkyGarden_Plaza_Show/StaticPrefabs/MG_Main_L0_X166_Y149.asset
Assets/Product/BigWorld/SkyGarden_Plaza_Show/StaticPrefabs/MG_Main_L0_X165_Y148.prefab	Assets/Product/AssetRef/BigWorld/SkyGarden_Plaza_Show/StaticPrefabs/MG_Main_L0_X165_Y148.asset
Assets/Product/BigWorld/SkyGarden_Plaza_Show/StaticPrefabs/MG_Main_L0_X164_Y146.prefab	Assets/Product/AssetRef/BigWorld/SkyGarden_Plaza_Show/StaticPrefabs/MG_Main_L0_X164_Y146.asset
Assets/Product/BigWorld/SkyGarden_Plaza_Show/StaticPrefabs/MG_Main_L0_X166_Y145.prefab	Assets/Product/AssetRef/BigWorld/SkyGarden_Plaza_Show/StaticPrefabs/MG_Main_L0_X166_Y145.asset
Assets/Product/BigWorld/SkyGarden_Plaza_Show/StaticPrefabs/MG_Main_L0_X163_Y148.prefab	Assets/Product/AssetRef/BigWorld/SkyGarden_Plaza_Show/StaticPrefabs/MG_Main_L0_X163_Y148.asset
Assets/Product/BigWorld/SkyGarden_Plaza_Show/StaticPrefabs/MG_Main_L0_X163_Y149.prefab	Assets/Product/AssetRef/BigWorld/SkyGarden_Plaza_Show/StaticPrefabs/MG_Main_L0_X163_Y149.asset
Assets/Product/BigWorld/SkyGarden_Plaza_Show/StaticPrefabs/MG_Main_L0_X164_Y144.prefab	Assets/Product/AssetRef/BigWorld/SkyGarden_Plaza_Show/StaticPrefabs/MG_Main_L0_X164_Y144.asset
Assets/Product/BigWorld/SkyGarden_Plaza_Show/StaticPrefabs/MG_Main_L0_X162_Y147.prefab	Assets/Product/AssetRef/BigWorld/SkyGarden_Plaza_Show/StaticPrefabs/MG_Main_L0_X162_Y147.asset
Assets/Product/BigWorld/SkyGarden_Plaza_Show/StaticPrefabs/MG_Main_L0_X165_Y144.prefab	Assets/Product/AssetRef/BigWorld/SkyGarden_Plaza_Show/StaticPrefabs/MG_Main_L0_X165_Y144.asset
Assets/Product/BigWorld/SkyGarden_Plaza_Show/StaticPrefabs/MG_Main_L0_X165_Y146.prefab	Assets/Product/AssetRef/BigWorld/SkyGarden_Plaza_Show/StaticPrefabs/MG_Main_L0_X165_Y146.asset
Assets/Product/BigWorld/SkyGarden_Plaza_Show/StaticPrefabs/MG_Main_L0_X164_Y148.prefab	Assets/Product/AssetRef/BigWorld/SkyGarden_Plaza_Show/StaticPrefabs/MG_Main_L0_X164_Y148.asset
Assets/Product/BigWorld/SkyGarden_Plaza_Show/StaticPrefabs/MG_Main_L0_X167_Y147.prefab	Assets/Product/AssetRef/BigWorld/SkyGarden_Plaza_Show/StaticPrefabs/MG_Main_L0_X167_Y147.asset
Assets/Product/BigWorld/SkyGarden_Plaza_Show/StaticPrefabs/MG_Main_L0_X168_Y149.prefab	Assets/Product/AssetRef/BigWorld/SkyGarden_Plaza_Show/StaticPrefabs/MG_Main_L0_X168_Y149.asset
Assets/Product/BigWorld/SkyGarden_Plaza_Show/StaticPrefabs/MG_Main_L0_X166_Y144.prefab	Assets/Product/AssetRef/BigWorld/SkyGarden_Plaza_Show/StaticPrefabs/MG_Main_L0_X166_Y144.asset
Assets/Product/BigWorld/SkyGarden_Plaza_Show/StaticPrefabs/MG_Main_L0_X161_Y145.prefab	Assets/Product/AssetRef/BigWorld/SkyGarden_Plaza_Show/StaticPrefabs/MG_Main_L0_X161_Y145.asset
Assets/Product/BigWorld/SkyGarden_Plaza_Show/StaticPrefabs/MG_Main_L0_X169_Y149.prefab	Assets/Product/AssetRef/BigWorld/SkyGarden_Plaza_Show/StaticPrefabs/MG_Main_L0_X169_Y149.asset
Assets/Product/BigWorld/SkyGarden_Plaza_Show/StaticPrefabs/MG_Main_L0_X169_Y148.prefab	Assets/Product/AssetRef/BigWorld/SkyGarden_Plaza_Show/StaticPrefabs/MG_Main_L0_X169_Y148.asset
Assets/Product/BigWorld/SkyGarden_Plaza_Show/StaticPrefabs/MG_Main_L0_X170_Y149.prefab	Assets/Product/AssetRef/BigWorld/SkyGarden_Plaza_Show/StaticPrefabs/MG_Main_L0_X170_Y149.asset
Assets/Product/BigWorld/SkyGarden_Plaza_Show/StaticPrefabs/MG_Main_L0_X161_Y147.prefab	Assets/Product/AssetRef/BigWorld/SkyGarden_Plaza_Show/StaticPrefabs/MG_Main_L0_X161_Y147.asset
Assets/Product/BigWorld/SkyGarden_Plaza_Show/StaticPrefabs/MG_Main_L0_X165_Y150.prefab	Assets/Product/AssetRef/BigWorld/SkyGarden_Plaza_Show/StaticPrefabs/MG_Main_L0_X165_Y150.asset
Assets/Product/BigWorld/SkyGarden_Plaza_Show/StaticPrefabs/MG_Main_L0_X166_Y150.prefab	Assets/Product/AssetRef/BigWorld/SkyGarden_Plaza_Show/StaticPrefabs/MG_Main_L0_X166_Y150.asset
Assets/Product/BigWorld/SkyGarden_Plaza_Show/StaticPrefabs/MG_Main_L1_X82_Y73.prefab	Assets/Product/AssetRef/BigWorld/SkyGarden_Plaza_Show/StaticPrefabs/MG_Main_L1_X82_Y73.asset
Assets/Product/BigWorld/SkyGarden_Plaza_Show/StaticPrefabs/MG_Main_L1_X81_Y73.prefab	Assets/Product/AssetRef/BigWorld/SkyGarden_Plaza_Show/StaticPrefabs/MG_Main_L1_X81_Y73.asset
Assets/Product/BigWorld/SkyGarden_Plaza_Show/StaticPrefabs/MG_Main_L1_X82_Y72.prefab	Assets/Product/AssetRef/BigWorld/SkyGarden_Plaza_Show/StaticPrefabs/MG_Main_L1_X82_Y72.asset
Assets/Product/BigWorld/SkyGarden_Plaza_Show/StaticPrefabs/MG_Main_L1_X83_Y73.prefab	Assets/Product/AssetRef/BigWorld/SkyGarden_Plaza_Show/StaticPrefabs/MG_Main_L1_X83_Y73.asset
Assets/Product/BigWorld/SkyGarden_Plaza_Show/StaticPrefabs/MG_Main_L1_X83_Y74.prefab	Assets/Product/AssetRef/BigWorld/SkyGarden_Plaza_Show/StaticPrefabs/MG_Main_L1_X83_Y74.asset
Assets/Product/BigWorld/SkyGarden_Plaza_Show/StaticPrefabs/MG_Main_L1_X85_Y75.prefab	Assets/Product/AssetRef/BigWorld/SkyGarden_Plaza_Show/StaticPrefabs/MG_Main_L1_X85_Y75.asset
Assets/Product/BigWorld/SkyGarden_Plaza_Show/StaticPrefabs/MG_Main_L1_X82_Y74.prefab	Assets/Product/AssetRef/BigWorld/SkyGarden_Plaza_Show/StaticPrefabs/MG_Main_L1_X82_Y74.asset
Assets/Product/BigWorld/SkyGarden_Plaza_Show/StaticPrefabs/MG_Main_L1_X81_Y74.prefab	Assets/Product/AssetRef/BigWorld/SkyGarden_Plaza_Show/StaticPrefabs/MG_Main_L1_X81_Y74.asset
Assets/Product/BigWorld/SkyGarden_Plaza_Show/StaticPrefabs/MG_Main_L1_X84_Y74.prefab	Assets/Product/AssetRef/BigWorld/SkyGarden_Plaza_Show/StaticPrefabs/MG_Main_L1_X84_Y74.asset
Assets/Product/BigWorld/SkyGarden_Plaza_Show/StaticPrefabs/MG_Main_L1_X83_Y72.prefab	Assets/Product/AssetRef/BigWorld/SkyGarden_Plaza_Show/StaticPrefabs/MG_Main_L1_X83_Y72.asset
Assets/Product/BigWorld/SkyGarden_Plaza_Show/StaticPrefabs/MG_Main_L1_X83_Y75.prefab	Assets/Product/AssetRef/BigWorld/SkyGarden_Plaza_Show/StaticPrefabs/MG_Main_L1_X83_Y75.asset
Assets/Product/BigWorld/SkyGarden_Plaza_Show/StaticPrefabs/MG_Main_L2_X41_Y37.prefab	Assets/Product/AssetRef/BigWorld/SkyGarden_Plaza_Show/StaticPrefabs/MG_Main_L2_X41_Y37.asset
Assets/Product/BigWorld/SkyGarden_Plaza_Show/StaticPrefabs/MG_Main_L2_X41_Y36.prefab	Assets/Product/AssetRef/BigWorld/SkyGarden_Plaza_Show/StaticPrefabs/MG_Main_L2_X41_Y36.asset
Assets/Product/BigWorld/SkyGarden_Plaza_Show/StaticPrefabs/MG_Main_L2_X42_Y38.prefab	Assets/Product/AssetRef/BigWorld/SkyGarden_Plaza_Show/StaticPrefabs/MG_Main_L2_X42_Y38.asset
Assets/Product/BigWorld/SkyGarden_Plaza_Show/StaticPrefabs/MG_Main_L2_X42_Y37.prefab	Assets/Product/AssetRef/BigWorld/SkyGarden_Plaza_Show/StaticPrefabs/MG_Main_L2_X42_Y37.asset
Assets/Product/BigWorld/SkyGarden_Plaza_Show/StaticPrefabs/MG_Main_L2_X40_Y36.prefab	Assets/Product/AssetRef/BigWorld/SkyGarden_Plaza_Show/StaticPrefabs/MG_Main_L2_X40_Y36.asset
Assets/Product/BigWorld/SkyGarden_Plaza_Show/StaticPrefabs/MG_Main_L3_X21_Y19.prefab	Assets/Product/AssetRef/BigWorld/SkyGarden_Plaza_Show/StaticPrefabs/MG_Main_L3_X21_Y19.asset
Assets/Product/BigWorld/SkyGarden_Plaza_Show/StaticPrefabs/MG_Main_L3_X20_Y18.prefab	Assets/Product/AssetRef/BigWorld/SkyGarden_Plaza_Show/StaticPrefabs/MG_Main_L3_X20_Y18.asset
Assets/Product/BigWorld/SkyGarden_Plaza_Show/StaticPrefabs/MG_Main_L3_X21_Y18.prefab	Assets/Product/AssetRef/BigWorld/SkyGarden_Plaza_Show/StaticPrefabs/MG_Main_L3_X21_Y18.asset
Assets/Product/BigWorld/SkyGarden_Plaza_Show/StaticPrefabs/MG_Main_L4_X10_Y9.prefab	Assets/Product/AssetRef/BigWorld/SkyGarden_Plaza_Show/StaticPrefabs/MG_Main_L4_X10_Y9.asset
Assets/Product/BigWorld/SkyGarden_Plaza_Show/StaticPrefabs/MG_Main_L4_X11_Y9.prefab	Assets/Product/AssetRef/BigWorld/SkyGarden_Plaza_Show/StaticPrefabs/MG_Main_L4_X11_Y9.asset
Assets/Product/BigWorld/SkyGarden_Plaza_Show/StaticPrefabs/MG_Main_L5_X5_Y5.prefab	Assets/Product/AssetRef/BigWorld/SkyGarden_Plaza_Show/StaticPrefabs/MG_Main_L5_X5_Y5.asset
Assets/Product/BigWorld/SkyGarden_Scene001/StaticPrefabs/MG_Main_L5_X2_Y2.prefab	Assets/Product/AssetRef/BigWorld/SkyGarden_Scene001/StaticPrefabs/MG_Main_L5_X2_Y2.asset
Assets/Product/BigWorld/SkyGarden_Scene001/StaticPrefabs/MG_Main_L7_X0_Y0.prefab	Assets/Product/AssetRef/BigWorld/SkyGarden_Scene001/StaticPrefabs/MG_Main_L7_X0_Y0.asset
Assets/Product/BigWorld/SkyGarden_Scene002/StaticPrefabs/MG_Main_L7_X0_Y0.prefab	Assets/Product/AssetRef/BigWorld/SkyGarden_Scene002/StaticPrefabs/MG_Main_L7_X0_Y0.asset
Assets/Product/BigWorld/SkyGarden_Scene003/StaticPrefabs/MG_Main_L0_X128_Y128.prefab	Assets/Product/AssetRef/BigWorld/SkyGarden_Scene003/StaticPrefabs/MG_Main_L0_X128_Y128.asset
Assets/Product/BigWorld/SkyGarden_Scene003/StaticPrefabs/MG_Main_L6_X2_Y2.prefab	Assets/Product/AssetRef/BigWorld/SkyGarden_Scene003/StaticPrefabs/MG_Main_L6_X2_Y2.asset
Assets/Product/BigWorld/SkyGarden_Scene003/StaticPrefabs/MG_Main_L8_X0_Y0.prefab	Assets/Product/AssetRef/BigWorld/SkyGarden_Scene003/StaticPrefabs/MG_Main_L8_X0_Y0.asset
Assets/Product/BigWorld/SkyGarden_Scene004/StaticPrefabs/MG_Main_L8_X0_Y0.prefab	Assets/Product/AssetRef/BigWorld/SkyGarden_Scene004/StaticPrefabs/MG_Main_L8_X0_Y0.asset
Assets/Product/BigWorld/SkyGarden_Scene005/StaticPrefabs/MG_Main_L8_X0_Y0.prefab	Assets/Product/AssetRef/BigWorld/SkyGarden_Scene005/StaticPrefabs/MG_Main_L8_X0_Y0.asset
Assets/Product/BigWorld/SkyGarden/SceneObjectPrefabs/SG_Com_JH_008Chestlv01_Ani.prefab	Assets/Product/AssetRef/BigWorld/SkyGarden/SceneObjectPrefabs/SG_Com_JH_008Chestlv01_Ani.asset
Assets/Product/BigWorld/SkyGarden/SceneObjectPrefabs/SG_Com_JH_009Chestlv02_Ani.prefab	Assets/Product/AssetRef/BigWorld/SkyGarden/SceneObjectPrefabs/SG_Com_JH_009Chestlv02_Ani.asset
Assets/Product/BigWorld/SkyGarden/SceneObjectPrefabs/SG_Com_JH_010Chestlv03_Ani.prefab	Assets/Product/AssetRef/BigWorld/SkyGarden/SceneObjectPrefabs/SG_Com_JH_010Chestlv03_Ani.asset
Assets/Product/BigWorld/SkyGarden/SceneObjectPrefabs/SG_Com_JH_Terminal.prefab	Assets/Product/AssetRef/BigWorld/SkyGarden/SceneObjectPrefabs/SG_Com_JH_Terminal.asset
Assets/Product/BigWorld/SkyGarden/SceneObjectPrefabs/SG_Com_JH_011Tudianxin.prefab	Assets/Product/AssetRef/BigWorld/SkyGarden/SceneObjectPrefabs/SG_Com_JH_011Tudianxin.asset
Assets/Product/BigWorld/SkyGarden/TempPrefabs/SG_Pla_WG_013Handbook01.prefab	Assets/Product/AssetRef/BigWorld/SkyGarden/TempPrefabs/SG_Pla_WG_013Handbook01.asset
Assets/Product/BigWorld/SkyGarden/TempPrefabs/SG_Pla_WG_013Handbook02.prefab	Assets/Product/AssetRef/BigWorld/SkyGarden/TempPrefabs/SG_Pla_WG_013Handbook02.asset
Assets/Product/BigWorld/SkyGarden/TempPrefabs/SG_Com_JH_Furnishing01.prefab	Assets/Product/AssetRef/BigWorld/SkyGarden/TempPrefabs/SG_Com_JH_Furnishing01.asset
Assets/Product/BigWorld/SkyGarden/TempPrefabs/SG_Com_JH_Bench01_02.prefab	Assets/Product/AssetRef/BigWorld/SkyGarden/TempPrefabs/SG_Com_JH_Bench01_02.asset
Assets/Product/BigWorld/SkyGarden/TempPrefabs/SG_Com_JH_Bench01_01.prefab	Assets/Product/AssetRef/BigWorld/SkyGarden/TempPrefabs/SG_Com_JH_Bench01_01.asset
Assets/Product/BigWorld/SkyGarden/TempPrefabs/SG_Pla_BD_bakery01.prefab	Assets/Product/AssetRef/BigWorld/SkyGarden/TempPrefabs/SG_Pla_BD_bakery01.asset
Assets/Product/BigWorld/SkyGarden/TempPrefabs/SG_Pla_ST_Guanggaota.prefab	Assets/Product/AssetRef/BigWorld/SkyGarden/TempPrefabs/SG_Pla_ST_Guanggaota.asset
Assets/Product/BigWorld/SkyGarden/TempPrefabs/SG_Pla_BD_Dingpeng01.prefab	Assets/Product/AssetRef/BigWorld/SkyGarden/TempPrefabs/SG_Pla_BD_Dingpeng01.asset
Assets/Product/BigWorld/SkyGarden_SuShe/SceneObjectPrefabs/SG_Sushe_JH_013diyBox.prefab	Assets/Product/AssetRef/BigWorld/SkyGarden_SuShe/SceneObjectPrefabs/SG_Sushe_JH_013diyBox.asset
Assets/Product/BigWorld/SkyGarden_SuShe/SceneObjectPrefabs/SG_Sushe_JH_013diyqiang.prefab	Assets/Product/AssetRef/BigWorld/SkyGarden_SuShe/SceneObjectPrefabs/SG_Sushe_JH_013diyqiang.asset
Assets/Product/BigWorld/SkyGarden_SuShe/SceneObjectPrefabs/SG_Sushe_Diy03.prefab	Assets/Product/AssetRef/BigWorld/SkyGarden_SuShe/SceneObjectPrefabs/SG_Sushe_Diy03.asset
Assets/Product/BigWorld/SkyGarden_SuShe/SceneObjectPrefabs/SG_Sushe_Diy04.prefab	Assets/Product/AssetRef/BigWorld/SkyGarden_SuShe/SceneObjectPrefabs/SG_Sushe_Diy04.asset
Assets/Product/BigWorld/SkyGarden_SuShe/SceneObjectPrefabs/SG_Sushe_Diy05.prefab	Assets/Product/AssetRef/BigWorld/SkyGarden_SuShe/SceneObjectPrefabs/SG_Sushe_Diy05.asset
Assets/Product/BigWorld/SkyGarden_SuShe/SceneObjectPrefabs/SG_Sushe_Diy06.prefab	Assets/Product/AssetRef/BigWorld/SkyGarden_SuShe/SceneObjectPrefabs/SG_Sushe_Diy06.asset
Assets/Product/BigWorld/SkyGarden_SuShe/SceneObjectPrefabs/SG_Sushe_Diy07.prefab	Assets/Product/AssetRef/BigWorld/SkyGarden_SuShe/SceneObjectPrefabs/SG_Sushe_Diy07.asset
Assets/Product/BigWorld/SkyGarden/TempPrefabs/SG_Pla_BD_Zhanbudian01.prefab	Assets/Product/AssetRef/BigWorld/SkyGarden/TempPrefabs/SG_Pla_BD_Zhanbudian01.asset
Assets/Product/BigWorld/SkyGarden/TempPrefabs/SG_Pla_BD_Clothstore01.prefab	Assets/Product/AssetRef/BigWorld/SkyGarden/TempPrefabs/SG_Pla_BD_Clothstore01.asset
Assets/Product/BigWorld/SkyGarden/TempPrefabs/SG_Pla_BD_Huadian01.prefab	Assets/Product/AssetRef/BigWorld/SkyGarden/TempPrefabs/SG_Pla_BD_Huadian01.asset
Assets/Product/BigWorld/SkyGarden/TempPrefabs/SG_Pla_BD_Shudian01.prefab	Assets/Product/AssetRef/BigWorld/SkyGarden/TempPrefabs/SG_Pla_BD_Shudian01.asset
Assets/Product/BigWorld/SkyGarden/TempPrefabs/SG_Pla_BD_Cakeshop01.prefab	Assets/Product/AssetRef/BigWorld/SkyGarden/TempPrefabs/SG_Pla_BD_Cakeshop01.asset
Assets/Product/BigWorld/SkyGarden/TempPrefabs/SG_Pla_BD_Fzjshop01.prefab	Assets/Product/AssetRef/BigWorld/SkyGarden/TempPrefabs/SG_Pla_BD_Fzjshop01.asset
Assets/Product/BigWorld/SkyGarden/TempPrefabs/SG_Pla_BD_Snowshop01.prefab	Assets/Product/AssetRef/BigWorld/SkyGarden/TempPrefabs/SG_Pla_BD_Snowshop01.asset
Assets/Product/BigWorld/SkyGarden/TempPrefabs/SG_Pla_BD_jiulongshop01.prefab	Assets/Product/AssetRef/BigWorld/SkyGarden/TempPrefabs/SG_Pla_BD_jiulongshop01.asset
Assets/Product/BigWorld/SkyGarden/TempPrefabs/SG_Pla_BD_Adilaishop01.prefab	Assets/Product/AssetRef/BigWorld/SkyGarden/TempPrefabs/SG_Pla_BD_Adilaishop01.asset
Assets/Product/BigWorld/SkyGarden/TempPrefabs/SG_Pla_BD_Oceanshop01.prefab	Assets/Product/AssetRef/BigWorld/SkyGarden/TempPrefabs/SG_Pla_BD_Oceanshop01.asset
Assets/Product/BigWorld/SkyGarden/TempPrefabs/SG_Com_WG_Furnishing01_02.prefab	Assets/Product/AssetRef/BigWorld/SkyGarden/TempPrefabs/SG_Com_WG_Furnishing01_02.asset
Assets/Product/BigWorld/SkyGarden/TempPrefabs/SG_Com_WG_Zhuoyi01_01.prefab	Assets/Product/AssetRef/BigWorld/SkyGarden/TempPrefabs/SG_Com_WG_Zhuoyi01_01.asset
Assets/Product/BigWorld/SkyGarden/TempPrefabs/SG_Com_WG_Zhuoyi01_02.prefab	Assets/Product/AssetRef/BigWorld/SkyGarden/TempPrefabs/SG_Com_WG_Zhuoyi01_02.asset
Assets/Product/BigWorld/SkyGarden/TempPrefabs/SG_Com_WG_Zhuoyi01_03.prefab	Assets/Product/AssetRef/BigWorld/SkyGarden/TempPrefabs/SG_Com_WG_Zhuoyi01_03.asset
Assets/Product/BigWorld/SkyGarden/TempPrefabs/SG_Res_WG_Object01_01.prefab	Assets/Product/AssetRef/BigWorld/SkyGarden/TempPrefabs/SG_Res_WG_Object01_01.asset
Assets/Product/BigWorld/SkyGarden/TempPrefabs/SG_Res_JH_Batai01.prefab	Assets/Product/AssetRef/BigWorld/SkyGarden/TempPrefabs/SG_Res_JH_Batai01.asset
Assets/Product/BigWorld/SkyGarden_SuShe/SceneObjectPrefabs/SG_Sushe_JH_003Wujian02.prefab	Assets/Product/AssetRef/BigWorld/SkyGarden_SuShe/SceneObjectPrefabs/SG_Sushe_JH_003Wujian02.asset
Assets/Product/BigWorld/SkyGarden_SuShe/SceneObjectPrefabs/SG_Sushe_JH_003Wujian01.prefab	Assets/Product/AssetRef/BigWorld/SkyGarden_SuShe/SceneObjectPrefabs/SG_Sushe_JH_003Wujian01.asset
Assets/Product/BigWorld/SkyGarden/TempPrefabs/SG_Com_LED_002Pingmu01.prefab	Assets/Product/AssetRef/BigWorld/SkyGarden/TempPrefabs/SG_Com_LED_002Pingmu01.asset
Assets/Product/BigWorld/SkyGarden_SuShe/SceneObjectPrefabs/SG_Sushe_WG_032Qingwa.prefab	Assets/Product/AssetRef/BigWorld/SkyGarden_SuShe/SceneObjectPrefabs/SG_Sushe_WG_032Qingwa.asset
Assets/Product/BigWorld/SkyGarden_SuShe/SceneObjectPrefabs/SG_sushe_31Xiong01.prefab	Assets/Product/AssetRef/BigWorld/SkyGarden_SuShe/SceneObjectPrefabs/SG_sushe_31Xiong01.asset
Assets/Product/BigWorld/SkyGarden_SuShe/SceneObjectPrefabs/SG_sushe_19Liushengji.prefab	Assets/Product/AssetRef/BigWorld/SkyGarden_SuShe/SceneObjectPrefabs/SG_sushe_19Liushengji.asset
Assets/Product/BigWorld/SkyGarden/TempPrefabs/SG_Pun_BD_Dianti01.prefab	Assets/Product/AssetRef/BigWorld/SkyGarden/TempPrefabs/SG_Pun_BD_Dianti01.asset
Assets/Product/BigWorld/SkyGarden/TempPrefabs/SG_Com_JH_006Teleporter_Ani.prefab	Assets/Product/AssetRef/BigWorld/SkyGarden/TempPrefabs/SG_Com_JH_006Teleporter_Ani.asset
Assets/Product/BigWorld/SkyGarden/TempPrefabs/SG_Bar_WG_001Sofa.prefab	Assets/Product/AssetRef/BigWorld/SkyGarden/TempPrefabs/SG_Bar_WG_001Sofa.asset
Assets/Product/BigWorld/SkyGarden/TempPrefabs/SG_Bar_WG_002Sofa.prefab	Assets/Product/AssetRef/BigWorld/SkyGarden/TempPrefabs/SG_Bar_WG_002Sofa.asset
Assets/Product/BigWorld/SkyGarden/TempPrefabs/SG_Bar_WG_004Sofa.prefab	Assets/Product/AssetRef/BigWorld/SkyGarden/TempPrefabs/SG_Bar_WG_004Sofa.asset
Assets/Product/BigWorld/SkyGarden/TempPrefabs/SG_Bar_WG_003Sofa.prefab	Assets/Product/AssetRef/BigWorld/SkyGarden/TempPrefabs/SG_Bar_WG_003Sofa.asset
Assets/Product/BigWorld/SkyGarden/TempPrefabs/SG_Bar_WG_001Zhuozi.prefab	Assets/Product/AssetRef/BigWorld/SkyGarden/TempPrefabs/SG_Bar_WG_001Zhuozi.asset
Assets/Product/BigWorld/SkyGarden/TempPrefabs/SG_Bar_WG_002Zhuzi.prefab	Assets/Product/AssetRef/BigWorld/SkyGarden/TempPrefabs/SG_Bar_WG_002Zhuzi.asset
Assets/Product/BigWorld/SkyGarden/TempPrefabs/SG_Bar_WG_002Yizi.prefab	Assets/Product/AssetRef/BigWorld/SkyGarden/TempPrefabs/SG_Bar_WG_002Yizi.asset
Assets/Product/BigWorld/SkyGarden/TempPrefabs/SG_Pla_WG_003Quanxi02.prefab	Assets/Product/AssetRef/BigWorld/SkyGarden/TempPrefabs/SG_Pla_WG_003Quanxi02.asset
Assets/Product/BigWorld/SkyGarden/TempPrefabs/SG_Pla_WG_Berth01.prefab	Assets/Product/AssetRef/BigWorld/SkyGarden/TempPrefabs/SG_Pla_WG_Berth01.asset
Assets/Product/BigWorld/SkyGarden/TempPrefabs/SG_Pla_WG_Berth02.prefab	Assets/Product/AssetRef/BigWorld/SkyGarden/TempPrefabs/SG_Pla_WG_Berth02.asset
Assets/Product/BigWorld/SkyGarden/TempPrefabs/SG_Pla_WG_Berth03.prefab	Assets/Product/AssetRef/BigWorld/SkyGarden/TempPrefabs/SG_Pla_WG_Berth03.asset
Assets/Product/BigWorld/SkyGarden/TempPrefabs/SG_Pla_WG_Berth04.prefab	Assets/Product/AssetRef/BigWorld/SkyGarden/TempPrefabs/SG_Pla_WG_Berth04.asset
Assets/Product/BigWorld/SkyGarden/TempPrefabs/SG_Pla_WG_Berth05.prefab	Assets/Product/AssetRef/BigWorld/SkyGarden/TempPrefabs/SG_Pla_WG_Berth05.asset
Assets/Product/BigWorld/SkyGarden/TempPrefabs/SG_Pla_WG_Berth06.prefab	Assets/Product/AssetRef/BigWorld/SkyGarden/TempPrefabs/SG_Pla_WG_Berth06.asset
Assets/Product/BigWorld/SkyGarden/TempPrefabs/SG_Com_WG_Dustbin01_01.prefab	Assets/Product/AssetRef/BigWorld/SkyGarden/TempPrefabs/SG_Com_WG_Dustbin01_01.asset
Assets/Product/BigWorld/SkyGarden/SceneObjectPrefabs/SG_Com_JH_004Kafeibei01.prefab	Assets/Product/AssetRef/BigWorld/SkyGarden/SceneObjectPrefabs/SG_Com_JH_004Kafeibei01.asset
Assets/Product/BigWorld/SkyGarden/TempPrefabs/SG_Res_WG_Coffee02_07.prefab	Assets/Product/AssetRef/BigWorld/SkyGarden/TempPrefabs/SG_Res_WG_Coffee02_07.asset
Assets/Product/BigWorld/SkyGarden/SceneObjectPrefabs/SG_Pla_JH_013Handbook03.prefab	Assets/Product/AssetRef/BigWorld/SkyGarden/SceneObjectPrefabs/SG_Pla_JH_013Handbook03.asset
Assets/Product/BigWorld/SkyGarden/TempPrefabs/SG_Bar_WG_002Menu.prefab	Assets/Product/AssetRef/BigWorld/SkyGarden/TempPrefabs/SG_Bar_WG_002Menu.asset
Assets/Product/BigWorld/SkyGarden_JumpPlayer/TempPrefabs/SG_Ttl_WG_001Platform.prefab	Assets/Product/AssetRef/BigWorld/SkyGarden_JumpPlayer/TempPrefabs/SG_Ttl_WG_001Platform.asset
Assets/Product/BigWorld/SkyGarden_JumpPlayer/TempPrefabs/SG_Ttl_WG_002Platform.prefab	Assets/Product/AssetRef/BigWorld/SkyGarden_JumpPlayer/TempPrefabs/SG_Ttl_WG_002Platform.asset
Assets/Product/BigWorld/SkyGarden_SuShe/SceneObjectPrefabs/SkyGarden_SuShe_01.prefab	Assets/Product/AssetRef/BigWorld/SkyGarden_SuShe/SceneObjectPrefabs/SkyGarden_SuShe_01.asset
Assets/Product/BigWorld/SkyGarden/SceneObjectPrefabs/SG_Com_JH_Rukou01.prefab	Assets/Product/AssetRef/BigWorld/SkyGarden/SceneObjectPrefabs/SG_Com_JH_Rukou01.asset
Assets/Product/BigWorld/SkyGarden_SuShe/SceneObjectPrefabs/SG_Sushe_JH_Wujian01.prefab	Assets/Product/AssetRef/BigWorld/SkyGarden_SuShe/SceneObjectPrefabs/SG_Sushe_JH_Wujian01.asset
Assets/Product/BigWorld/SkyGarden_SuShe/SceneObjectPrefabs/SG_Sushe_JH_Wujian09.prefab	Assets/Product/AssetRef/BigWorld/SkyGarden_SuShe/SceneObjectPrefabs/SG_Sushe_JH_Wujian09.asset
Assets/Product/BigWorld/SkyGarden_SuShe/SceneObjectPrefabs/SG_Sushe_JH_Wujian02.prefab	Assets/Product/AssetRef/BigWorld/SkyGarden_SuShe/SceneObjectPrefabs/SG_Sushe_JH_Wujian02.asset
Assets/Product/BigWorld/SkyGarden_SuShe/SceneObjectPrefabs/SG_Sushe_WG_036Xiaoxiontz.prefab	Assets/Product/AssetRef/BigWorld/SkyGarden_SuShe/SceneObjectPrefabs/SG_Sushe_WG_036Xiaoxiontz.asset
Assets/Product/BigWorld/SkyGarden_SuShe/SceneObjectPrefabs/SG_Sushe_JH_Wujian04.prefab	Assets/Product/AssetRef/BigWorld/SkyGarden_SuShe/SceneObjectPrefabs/SG_Sushe_JH_Wujian04.asset
Assets/Product/BigWorld/SkyGarden_SuShe/SceneObjectPrefabs/SG_Sushe_JH_Clover.prefab	Assets/Product/AssetRef/BigWorld/SkyGarden_SuShe/SceneObjectPrefabs/SG_Sushe_JH_Clover.asset
Assets/Product/BigWorld/SkyGarden_SuShe/SceneObjectPrefabs/SG_Sushe_JH_Garland.prefab	Assets/Product/AssetRef/BigWorld/SkyGarden_SuShe/SceneObjectPrefabs/SG_Sushe_JH_Garland.asset
Assets/Product/BigWorld/SkyGarden_SuShe/SceneObjectPrefabs/SG_Sushe_JH_Wujian06.prefab	Assets/Product/AssetRef/BigWorld/SkyGarden_SuShe/SceneObjectPrefabs/SG_Sushe_JH_Wujian06.asset
Assets/Product/BigWorld/SkyGarden_SuShe/SceneObjectPrefabs/SG_Sushe_JH_Wujian05.prefab	Assets/Product/AssetRef/BigWorld/SkyGarden_SuShe/SceneObjectPrefabs/SG_Sushe_JH_Wujian05.asset
Assets/Product/BigWorld/SkyGarden_SuShe/SceneObjectPrefabs/SG_Sushe_JH_Wujian03.prefab	Assets/Product/AssetRef/BigWorld/SkyGarden_SuShe/SceneObjectPrefabs/SG_Sushe_JH_Wujian03.asset
Assets/Product/BigWorld/SkyGarden/TempPrefabs/SG_Pla_WG_003Quanxi01.prefab	Assets/Product/AssetRef/BigWorld/SkyGarden/TempPrefabs/SG_Pla_WG_003Quanxi01.asset
Assets/Product/BigWorld/SkyGarden/TempPrefabs/SG_Com_TX001.prefab	Assets/Product/AssetRef/BigWorld/SkyGarden/TempPrefabs/SG_Com_TX001.asset
Assets/Product/BigWorld/SkyGarden/SceneObjectPrefabs/SG_Com_JH_Zhuangzhi_Ani.prefab	Assets/Product/AssetRef/BigWorld/SkyGarden/SceneObjectPrefabs/SG_Com_JH_Zhuangzhi_Ani.asset
Assets/Product/BigWorld/SkyGarden/SceneObjectPrefabs/SG_Com_WG_031Qizhi01.prefab	Assets/Product/AssetRef/BigWorld/SkyGarden/SceneObjectPrefabs/SG_Com_WG_031Qizhi01.asset
Assets/Product/BigWorld/SkyGarden/SceneObjectPrefabs/SG_Com_WG_031Qizhi02.prefab	Assets/Product/AssetRef/BigWorld/SkyGarden/SceneObjectPrefabs/SG_Com_WG_031Qizhi02.asset
Assets/Product/BigWorld/SkyGarden/SceneObjectPrefabs/SG_Com_WG_032Qiqiu01.prefab	Assets/Product/AssetRef/BigWorld/SkyGarden/SceneObjectPrefabs/SG_Com_WG_032Qiqiu01.asset
Assets/Product/BigWorld/SkyGarden/SceneObjectPrefabs/SG_Com_WG_032Qiqiu02.prefab	Assets/Product/AssetRef/BigWorld/SkyGarden/SceneObjectPrefabs/SG_Com_WG_032Qiqiu02.asset
Assets/Product/BigWorld/SkyGarden/SceneObjectPrefabs/SG_Com_WG_032Qiqiu03.prefab	Assets/Product/AssetRef/BigWorld/SkyGarden/SceneObjectPrefabs/SG_Com_WG_032Qiqiu03.asset
Assets/Product/BigWorld/SkyGarden/SceneObjectPrefabs/SG_Com_WG_032Qiqiu04.prefab	Assets/Product/AssetRef/BigWorld/SkyGarden/SceneObjectPrefabs/SG_Com_WG_032Qiqiu04.asset
Assets/Product/BigWorld/SkyGarden/SceneObjectPrefabs/SG_Com_WG_032Qiqiu05.prefab	Assets/Product/AssetRef/BigWorld/SkyGarden/SceneObjectPrefabs/SG_Com_WG_032Qiqiu05.asset
Assets/Product/BigWorld/SkyGarden/SceneObjectPrefabs/SG_Com_WG_032Qiqiu06.prefab	Assets/Product/AssetRef/BigWorld/SkyGarden/SceneObjectPrefabs/SG_Com_WG_032Qiqiu06.asset
Assets/Product/BigWorld/SkyGarden/SceneObjectPrefabs/SG_Com_WG_032Qiqiu08.prefab	Assets/Product/AssetRef/BigWorld/SkyGarden/SceneObjectPrefabs/SG_Com_WG_032Qiqiu08.asset
Assets/Product/BigWorld/SkyGarden/SceneObjectPrefabs/SG_Com_WG_032Qiqiu10.prefab	Assets/Product/AssetRef/BigWorld/SkyGarden/SceneObjectPrefabs/SG_Com_WG_032Qiqiu10.asset
Assets/Product/BigWorld/SkyGarden/SceneObjectPrefabs/SG_Com_WG_033Liwuhe01.prefab	Assets/Product/AssetRef/BigWorld/SkyGarden/SceneObjectPrefabs/SG_Com_WG_033Liwuhe01.asset
Assets/Product/BigWorld/SkyGarden/SceneObjectPrefabs/SG_Com_WG_033Liwuhe02.prefab	Assets/Product/AssetRef/BigWorld/SkyGarden/SceneObjectPrefabs/SG_Com_WG_033Liwuhe02.asset
Assets/Product/BigWorld/SkyGarden/SceneObjectPrefabs/SG_Com_WG_033Liwuhe03.prefab	Assets/Product/AssetRef/BigWorld/SkyGarden/SceneObjectPrefabs/SG_Com_WG_033Liwuhe03.asset
Assets/Product/BigWorld/SkyGarden/SceneObjectPrefabs/SG_Com_WG_033Liwuhe05.prefab	Assets/Product/AssetRef/BigWorld/SkyGarden/SceneObjectPrefabs/SG_Com_WG_033Liwuhe05.asset
Assets/Product/BigWorld/SkyGarden/SceneObjectPrefabs/SG_Com_WG_033Liwuhe06.prefab	Assets/Product/AssetRef/BigWorld/SkyGarden/SceneObjectPrefabs/SG_Com_WG_033Liwuhe06.asset
Assets/Product/BigWorld/SkyGarden/SceneObjectPrefabs/SG_Com_WG_034Liwuhe.prefab	Assets/Product/AssetRef/BigWorld/SkyGarden/SceneObjectPrefabs/SG_Com_WG_034Liwuhe.asset
Assets/Product/BigWorld/SkyGarden/SceneObjectPrefabs/SG_Com_WG_035Fasheqi.prefab	Assets/Product/AssetRef/BigWorld/SkyGarden/SceneObjectPrefabs/SG_Com_WG_035Fasheqi.asset
Assets/Product/BigWorld/SkyGarden/SceneObjectPrefabs/SG_Com_WG_036Liwuhe.prefab	Assets/Product/AssetRef/BigWorld/SkyGarden/SceneObjectPrefabs/SG_Com_WG_036Liwuhe.asset
Assets/Product/BigWorld/SkyGarden/SceneObjectPrefabs/SG_Com_WG_037Menkuang.prefab	Assets/Product/AssetRef/BigWorld/SkyGarden/SceneObjectPrefabs/SG_Com_WG_037Menkuang.asset
Assets/Product/BigWorld/SkyGarden/SceneObjectPrefabs/SG_Com_WG_033Liwuhe04.prefab	Assets/Product/AssetRef/BigWorld/SkyGarden/SceneObjectPrefabs/SG_Com_WG_033Liwuhe04.asset
Assets/Product/BigWorld/SkyGarden/SceneObjectPrefabs/SG_Com_WG_Zhaopai01.prefab	Assets/Product/AssetRef/BigWorld/SkyGarden/SceneObjectPrefabs/SG_Com_WG_Zhaopai01.asset
Assets/Product/BigWorld/SkyGarden/SceneObjectPrefabs/SG_Com_WG_Zhaopai02.prefab	Assets/Product/AssetRef/BigWorld/SkyGarden/SceneObjectPrefabs/SG_Com_WG_Zhaopai02.asset
Assets/Product/BigWorld/SkyGarden/TempPrefabs/SG_Pla_WG_005Quanxi01.prefab	Assets/Product/AssetRef/BigWorld/SkyGarden/TempPrefabs/SG_Pla_WG_005Quanxi01.asset
Assets/Product/BigWorld/SkyGarden/SceneObjectPrefabs/SG_Com_JH_004Kafeibei.prefab	Assets/Product/AssetRef/BigWorld/SkyGarden/SceneObjectPrefabs/SG_Com_JH_004Kafeibei.asset
Assets/Product/BigWorld/SkyGarden/SceneObjectPrefabs/SG_Com_JH_001Clover.prefab	Assets/Product/AssetRef/BigWorld/SkyGarden/SceneObjectPrefabs/SG_Com_JH_001Clover.asset
Assets/Product/BigWorld/SkyGarden/SceneObjectPrefabs/SG_Com_JH_002Trialpass.prefab	Assets/Product/AssetRef/BigWorld/SkyGarden/SceneObjectPrefabs/SG_Com_JH_002Trialpass.asset
Assets/Product/BigWorld/SkyGarden/SceneObjectPrefabs/SG_Com_JH_002Dessert.prefab	Assets/Product/AssetRef/BigWorld/SkyGarden/SceneObjectPrefabs/SG_Com_JH_002Dessert.asset
Assets/Product/BigWorld/SkyGarden/SceneObjectPrefabs/SG_Com_JH_002Dishes.prefab	Assets/Product/AssetRef/BigWorld/SkyGarden/SceneObjectPrefabs/SG_Com_JH_002Dishes.asset
Assets/Product/BigWorld/SkyGarden/SceneObjectPrefabs/SG_Com_JH_004Zhuangzhi01.prefab	Assets/Product/AssetRef/BigWorld/SkyGarden/SceneObjectPrefabs/SG_Com_JH_004Zhuangzhi01.asset
Assets/Product/BigWorld/SkyGarden/SceneObjectPrefabs/SG_Com_JH_001Garland.prefab	Assets/Product/AssetRef/BigWorld/SkyGarden/SceneObjectPrefabs/SG_Com_JH_001Garland.asset
Assets/Product/BigWorld/SkyGarden/SceneObjectPrefabs/SG_Com_JH_001Cloverring.prefab	Assets/Product/AssetRef/BigWorld/SkyGarden/SceneObjectPrefabs/SG_Com_JH_001Cloverring.asset
Assets/Product/BigWorld/SkyGarden/SceneObjectPrefabs/SG_Com_JH_004Jiubei.prefab	Assets/Product/AssetRef/BigWorld/SkyGarden/SceneObjectPrefabs/SG_Com_JH_004Jiubei.asset
Assets/Product/BigWorld/SkyGarden/SceneObjectPrefabs/SG_Com_JH_004Huapen.prefab	Assets/Product/AssetRef/BigWorld/SkyGarden/SceneObjectPrefabs/SG_Com_JH_004Huapen.asset
Assets/Product/BigWorld/SkyGarden/SceneObjectPrefabs/SG_Com_JH_004Bliping.prefab	Assets/Product/AssetRef/BigWorld/SkyGarden/SceneObjectPrefabs/SG_Com_JH_004Bliping.asset
Assets/Product/BigWorld/SkyGarden/SceneObjectPrefabs/SG_Com_JH_005Zhi.prefab	Assets/Product/AssetRef/BigWorld/SkyGarden/SceneObjectPrefabs/SG_Com_JH_005Zhi.asset
Assets/Product/BigWorld/SkyGarden/SceneObjectPrefabs/SG_Com_JH_004Liwuhe.prefab	Assets/Product/AssetRef/BigWorld/SkyGarden/SceneObjectPrefabs/SG_Com_JH_004Liwuhe.asset
Assets/Product/BigWorld/SkyGarden/SceneObjectPrefabs/SG_Com_JH_004Liwuhe01.prefab	Assets/Product/AssetRef/BigWorld/SkyGarden/SceneObjectPrefabs/SG_Com_JH_004Liwuhe01.asset
Assets/Product/BigWorld/SkyGarden/SceneObjectPrefabs/SG_Com_JH_005Shikecao01.prefab	Assets/Product/AssetRef/BigWorld/SkyGarden/SceneObjectPrefabs/SG_Com_JH_005Shikecao01.asset
Assets/Product/BigWorld/SkyGarden/SceneObjectPrefabs/SG_Com_JH_005Shikecao02.prefab	Assets/Product/AssetRef/BigWorld/SkyGarden/SceneObjectPrefabs/SG_Com_JH_005Shikecao02.asset
Assets/Product/BigWorld/SkyGarden/SceneObjectPrefabs/SG_Pla_JH_005Cake.prefab	Assets/Product/AssetRef/BigWorld/SkyGarden/SceneObjectPrefabs/SG_Pla_JH_005Cake.asset
Assets/Product/BigWorld/SkyGarden_JumpPlayer/TempPrefabs/SG_Ttl_WG_002Platform1.prefab	Assets/Product/AssetRef/BigWorld/SkyGarden_JumpPlayer/TempPrefabs/SG_Ttl_WG_002Platform1.asset
Assets/Product/BigWorld/SkyGarden/SceneObjectPrefabs/SG_Com_JH_004Jiubei01.prefab	Assets/Product/AssetRef/BigWorld/SkyGarden/SceneObjectPrefabs/SG_Com_JH_004Jiubei01.asset
Assets/Product/BigWorld/SkyGarden/TempPrefabs/SG_Bar_WG_005Jiubei05.prefab	Assets/Product/AssetRef/BigWorld/SkyGarden/TempPrefabs/SG_Bar_WG_005Jiubei05.asset
Assets/Product/BigWorld/SkyGarden/TempPrefabs/SG_Bar_WG_005Jiubei03.prefab	Assets/Product/AssetRef/BigWorld/SkyGarden/TempPrefabs/SG_Bar_WG_005Jiubei03.asset
Assets/Product/BigWorld/SkyGarden/TempPrefabs/SG_Bar_WG_005Jiubei01.prefab	Assets/Product/AssetRef/BigWorld/SkyGarden/TempPrefabs/SG_Bar_WG_005Jiubei01.asset
Assets/Product/BigWorld/SkyGarden/TempPrefabs/SG_Bar_WG_005Jiubei02.prefab	Assets/Product/AssetRef/BigWorld/SkyGarden/TempPrefabs/SG_Bar_WG_005Jiubei02.asset
Assets/Product/BigWorld/SkyGarden/TempPrefabs/SG_Bar_WG_005Jiubei04.prefab	Assets/Product/AssetRef/BigWorld/SkyGarden/TempPrefabs/SG_Bar_WG_005Jiubei04.asset
Assets/Product/BigWorld/SkyGarden/TempPrefabs/SG_Bar_WG_004Jiuping01.prefab	Assets/Product/AssetRef/BigWorld/SkyGarden/TempPrefabs/SG_Bar_WG_004Jiuping01.asset
Assets/Product/BigWorld/SkyGarden/TempPrefabs/SG_Bar_WG_004Jiuping02.prefab	Assets/Product/AssetRef/BigWorld/SkyGarden/TempPrefabs/SG_Bar_WG_004Jiuping02.asset
Assets/Product/BigWorld/SkyGarden/TempPrefabs/SG_Bar_WG_004Jiuping03.prefab	Assets/Product/AssetRef/BigWorld/SkyGarden/TempPrefabs/SG_Bar_WG_004Jiuping03.asset
Assets/Product/BigWorld/SkyGarden/TempPrefabs/SG_Bar_WG_004Jiuping04.prefab	Assets/Product/AssetRef/BigWorld/SkyGarden/TempPrefabs/SG_Bar_WG_004Jiuping04.asset
Assets/Product/BigWorld/SkyGarden/SceneObjectPrefabs/SG_Com_JH_004Huapena.prefab	Assets/Product/AssetRef/BigWorld/SkyGarden/SceneObjectPrefabs/SG_Com_JH_004Huapena.asset
Assets/Product/BigWorld/SkyGarden/SceneObjectPrefabs/SG_Res_JH_Coffee01_02.prefab	Assets/Product/AssetRef/BigWorld/SkyGarden/SceneObjectPrefabs/SG_Res_JH_Coffee01_02.asset
Assets/Product/BigWorld/SkyGarden/TempPrefabs/SG_Res_WG_Coffee_Integrity.prefab	Assets/Product/AssetRef/BigWorld/SkyGarden/TempPrefabs/SG_Res_WG_Coffee_Integrity.asset
Assets/Product/BigWorld/SkyGarden_LxyStoryLevel02/SceneObjectPrefabs/SG_Lxy02_JH_Gravestone.prefab	Assets/Product/AssetRef/BigWorld/SkyGarden_LxyStoryLevel02/SceneObjectPrefabs/SG_Lxy02_JH_Gravestone.asset
Assets/Product/BigWorld/SkyGarden/SceneObjectPrefabs/SG_Com_JH_Xiannvbang.prefab	Assets/Product/AssetRef/BigWorld/SkyGarden/SceneObjectPrefabs/SG_Com_JH_Xiannvbang.asset
Assets/Product/BigWorld/SkyGarden/SceneObjectPrefabs/SG_Com_JH_001Clover01.prefab	Assets/Product/AssetRef/BigWorld/SkyGarden/SceneObjectPrefabs/SG_Com_JH_001Clover01.asset
Assets/Product/BigWorld/SkyGarden/TempPrefabs/SG_Ttl_WG_Zhuzi01Variant.prefab	Assets/Product/AssetRef/BigWorld/SkyGarden/TempPrefabs/SG_Ttl_WG_Zhuzi01Variant.asset
Assets/Product/BigWorld/SkyGarden/TempPrefabs/SG_Ttl_WG_Zhuzi02Variant.prefab	Assets/Product/AssetRef/BigWorld/SkyGarden/TempPrefabs/SG_Ttl_WG_Zhuzi02Variant.asset
Assets/Product/BigWorld/SkyGarden/TempPrefabs/S04601_07Door02Ani_Copy.prefab	Assets/Product/AssetRef/BigWorld/SkyGarden/TempPrefabs/S04601_07Door02Ani_Copy.asset
Assets/Product/BigWorld/SkyGarden/TempPrefabs/S04601_07DoorAni_Copy.prefab	Assets/Product/AssetRef/BigWorld/SkyGarden/TempPrefabs/S04601_07DoorAni_Copy.asset
Assets/Product/BigWorld/SkyGarden/TempPrefabs/S04602_11Jbsmen02Ani_Copy.prefab	Assets/Product/AssetRef/BigWorld/SkyGarden/TempPrefabs/S04602_11Jbsmen02Ani_Copy.asset
Assets/Product/BigWorld/SkyGarden/TempPrefabs/SG_Com_WG_057Shipin01.prefab	Assets/Product/AssetRef/BigWorld/SkyGarden/TempPrefabs/SG_Com_WG_057Shipin01.asset
Assets/Product/BigWorld/SkyGarden/TempPrefabs/SG_Com_WG_057Shipin02.prefab	Assets/Product/AssetRef/BigWorld/SkyGarden/TempPrefabs/SG_Com_WG_057Shipin02.asset
Assets/Product/BigWorld/SkyGarden/TempPrefabs/SG_Com_WG_057Shipin05.prefab	Assets/Product/AssetRef/BigWorld/SkyGarden/TempPrefabs/SG_Com_WG_057Shipin05.asset
Assets/Product/BigWorld/SkyGarden/TempPrefabs/SG_Com_WG_057Shipin03.prefab	Assets/Product/AssetRef/BigWorld/SkyGarden/TempPrefabs/SG_Com_WG_057Shipin03.asset
Assets/Product/BigWorld/SkyGarden/TempPrefabs/SG_Com_WG_057Shipin04.prefab	Assets/Product/AssetRef/BigWorld/SkyGarden/TempPrefabs/SG_Com_WG_057Shipin04.asset
Assets/Product/BigWorld/SkyGarden_LxyStoryLevel02/TempPrefabs/SG_Lxy02_TP_007Cao.prefab	Assets/Product/AssetRef/BigWorld/SkyGarden_LxyStoryLevel02/TempPrefabs/SG_Lxy02_TP_007Cao.asset
Assets/Product/BigWorld/SkyGarden_LxyStoryLevel02/TempPrefabs/SG_Lxy02_TP_007Caoa.prefab	Assets/Product/AssetRef/BigWorld/SkyGarden_LxyStoryLevel02/TempPrefabs/SG_Lxy02_TP_007Caoa.asset
Assets/Product/BigWorld/SkyGarden_LxyStoryLevel02/TempPrefabs/SG_Lxy02_TP_007Caob.prefab	Assets/Product/AssetRef/BigWorld/SkyGarden_LxyStoryLevel02/TempPrefabs/SG_Lxy02_TP_007Caob.asset
Assets/Product/BigWorld/SkyGarden_LxyStoryLevel02/TempPrefabs/SG_Lxy02_TP_004Zhiwu01.prefab	Assets/Product/AssetRef/BigWorld/SkyGarden_LxyStoryLevel02/TempPrefabs/SG_Lxy02_TP_004Zhiwu01.asset
Assets/Product/BigWorld/SkyGarden_LxyStoryLevel02/TempPrefabs/SG_Lxy02_TP_004Zhiwu02.prefab	Assets/Product/AssetRef/BigWorld/SkyGarden_LxyStoryLevel02/TempPrefabs/SG_Lxy02_TP_004Zhiwu02.asset
Assets/Product/BigWorld/SkyGarden_LxyStoryLevel02/TempPrefabs/SG_Lxy02_TP_004Zhiwu03.prefab	Assets/Product/AssetRef/BigWorld/SkyGarden_LxyStoryLevel02/TempPrefabs/SG_Lxy02_TP_004Zhiwu03.asset
Assets/Product/BigWorld/SkyGarden_LxyStoryLevel02/TempPrefabs/SG_Lxy02_TP_006Zhiwu.prefab	Assets/Product/AssetRef/BigWorld/SkyGarden_LxyStoryLevel02/TempPrefabs/SG_Lxy02_TP_006Zhiwu.asset
Assets/Product/BigWorld/SkyGarden_LxyStoryLevel02/TempPrefabs/SG_Lxy02_TP_005Zhiwu01.prefab	Assets/Product/AssetRef/BigWorld/SkyGarden_LxyStoryLevel02/TempPrefabs/SG_Lxy02_TP_005Zhiwu01.asset
Assets/Product/BigWorld/SkyGarden_LxyStoryLevel02/TempPrefabs/SG_Lxy02_TP_006Huaban.prefab	Assets/Product/AssetRef/BigWorld/SkyGarden_LxyStoryLevel02/TempPrefabs/SG_Lxy02_TP_006Huaban.asset
Assets/Product/BigWorld/SkyGarden_LxyStoryLevel02/TempPrefabs/SG_Lxy02_TP_004Tree.prefab	Assets/Product/AssetRef/BigWorld/SkyGarden_LxyStoryLevel02/TempPrefabs/SG_Lxy02_TP_004Tree.asset
Assets/Product/BigWorld/SkyGarden_LxyStoryLevel02/TempPrefabs/SG_Lxy02_TP_004Tree03.prefab	Assets/Product/AssetRef/BigWorld/SkyGarden_LxyStoryLevel02/TempPrefabs/SG_Lxy02_TP_004Tree03.asset
Assets/Product/BigWorld/SkyGarden_LxyStoryLevel02/TempPrefabs/SG_Lxy02_TP_004Tree04.prefab	Assets/Product/AssetRef/BigWorld/SkyGarden_LxyStoryLevel02/TempPrefabs/SG_Lxy02_TP_004Tree04.asset
Assets/Product/BigWorld/SkyGarden_LxyStoryLevel02/TempPrefabs/SG_Lxy02_TP_004Tree05.prefab	Assets/Product/AssetRef/BigWorld/SkyGarden_LxyStoryLevel02/TempPrefabs/SG_Lxy02_TP_004Tree05.asset
Assets/Product/BigWorld/SkyGarden_LxyStoryLevel02/TempPrefabs/SG_Lxy02_TP_004Tree06.prefab	Assets/Product/AssetRef/BigWorld/SkyGarden_LxyStoryLevel02/TempPrefabs/SG_Lxy02_TP_004Tree06.asset
Assets/Product/BigWorld/SkyGarden_LxyStoryLevel02/TempPrefabs/SG_Lxy02_TP_003Shuzhi.prefab	Assets/Product/AssetRef/BigWorld/SkyGarden_LxyStoryLevel02/TempPrefabs/SG_Lxy02_TP_003Shuzhi.asset
Assets/Product/BigWorld/SkyGarden_LxyStoryLevel02/TempPrefabs/SG_Lxy02_PR_008Shugen.prefab	Assets/Product/AssetRef/BigWorld/SkyGarden_LxyStoryLevel02/TempPrefabs/SG_Lxy02_PR_008Shugen.asset
Assets/Product/BigWorld/SkyGarden_LxyStoryLevel02/TempPrefabs/SG_Lxy02_PR_Tree01.prefab	Assets/Product/AssetRef/BigWorld/SkyGarden_LxyStoryLevel02/TempPrefabs/SG_Lxy02_PR_Tree01.asset
Assets/Product/BigWorld/SkyGarden/SceneObjectPrefabs/SG_Com_JH_01_Lxyphoto.prefab	Assets/Product/AssetRef/BigWorld/SkyGarden/SceneObjectPrefabs/SG_Com_JH_01_Lxyphoto.asset
Assets/Product/BigWorld/SkyGarden/TempPrefabs/SG_Com_JH_017Plate.prefab	Assets/Product/AssetRef/BigWorld/SkyGarden/TempPrefabs/SG_Com_JH_017Plate.asset
Assets/Product/BigWorld/SkyGarden_LxyStoryLevel04/SceneObjectPrefabs/SG_Lxy04_JH_Shu01.prefab	Assets/Product/AssetRef/BigWorld/SkyGarden_LxyStoryLevel04/SceneObjectPrefabs/SG_Lxy04_JH_Shu01.asset
Assets/Product/BigWorld/SkyGarden_LxyStoryLevel04/SceneObjectPrefabs/SG_Lxy04_JH_Caocong01.prefab	Assets/Product/AssetRef/BigWorld/SkyGarden_LxyStoryLevel04/SceneObjectPrefabs/SG_Lxy04_JH_Caocong01.asset
Assets/Product/BigWorld/SkyGarden_LxyStoryLevel04/SceneObjectPrefabs/SG_Lxy04_JH_Huangshan01.prefab	Assets/Product/AssetRef/BigWorld/SkyGarden_LxyStoryLevel04/SceneObjectPrefabs/SG_Lxy04_JH_Huangshan01.asset
Assets/Product/BigWorld/SkyGarden_LxyStoryLevel04/SceneObjectPrefabs/SG_Lxy04_JH_Huangshan02.prefab	Assets/Product/AssetRef/BigWorld/SkyGarden_LxyStoryLevel04/SceneObjectPrefabs/SG_Lxy04_JH_Huangshan02.asset
Assets/Product/BigWorld/SkyGarden_LxyStoryLevel04/SceneObjectPrefabs/SG_Lxy04_JH_Huangshan03.prefab	Assets/Product/AssetRef/BigWorld/SkyGarden_LxyStoryLevel04/SceneObjectPrefabs/SG_Lxy04_JH_Huangshan03.asset
Assets/Product/BigWorld/SkyGarden_LxyStoryLevel04/SceneObjectPrefabs/SG_Lxy04_JH_Yunduo01.prefab	Assets/Product/AssetRef/BigWorld/SkyGarden_LxyStoryLevel04/SceneObjectPrefabs/SG_Lxy04_JH_Yunduo01.asset
Assets/Product/BigWorld/SkyGarden_LxyStoryLevel04/SceneObjectPrefabs/SG_Lxy04_JH_Yunduo02.prefab	Assets/Product/AssetRef/BigWorld/SkyGarden_LxyStoryLevel04/SceneObjectPrefabs/SG_Lxy04_JH_Yunduo02.asset
Assets/Product/BigWorld/SkyGarden_LxyStoryLevel04/SceneObjectPrefabs/SG_Lxy04_JH_Yunduo03.prefab	Assets/Product/AssetRef/BigWorld/SkyGarden_LxyStoryLevel04/SceneObjectPrefabs/SG_Lxy04_JH_Yunduo03.asset
Assets/Product/BigWorld/SkyGarden_LxyStoryLevel04/SceneObjectPrefabs/SG_Lxy04_JH_Yunduo04.prefab	Assets/Product/AssetRef/BigWorld/SkyGarden_LxyStoryLevel04/SceneObjectPrefabs/SG_Lxy04_JH_Yunduo04.asset
Assets/Product/BigWorld/SkyGarden_LxyStoryLevel04/SceneObjectPrefabs/SG_Lxy04_JH_Yunduo05.prefab	Assets/Product/AssetRef/BigWorld/SkyGarden_LxyStoryLevel04/SceneObjectPrefabs/SG_Lxy04_JH_Yunduo05.asset
Assets/Product/BigWorld/SkyGarden_LxyStoryLevel04/SceneObjectPrefabs/SG_Lxy04_JH_Yunduo06.prefab	Assets/Product/AssetRef/BigWorld/SkyGarden_LxyStoryLevel04/SceneObjectPrefabs/SG_Lxy04_JH_Yunduo06.asset
Assets/Product/BigWorld/SkyGarden_LxyStoryLevel04/SceneObjectPrefabs/SG_Lxy04_JH_Xingxing01.prefab	Assets/Product/AssetRef/BigWorld/SkyGarden_LxyStoryLevel04/SceneObjectPrefabs/SG_Lxy04_JH_Xingxing01.asset
Assets/Product/BigWorld/SkyGarden_LxyStoryLevel04/SceneObjectPrefabs/SG_Lxy04_JH_Xingxing02.prefab	Assets/Product/AssetRef/BigWorld/SkyGarden_LxyStoryLevel04/SceneObjectPrefabs/SG_Lxy04_JH_Xingxing02.asset
Assets/Product/BigWorld/SkyGarden_LxyStoryLevel04/SceneObjectPrefabs/SG_Lxy04_JH_Shan01.prefab	Assets/Product/AssetRef/BigWorld/SkyGarden_LxyStoryLevel04/SceneObjectPrefabs/SG_Lxy04_JH_Shan01.asset
Assets/Product/BigWorld/SkyGarden_LxyStoryLevel04/SceneObjectPrefabs/SG_Lxy04_JH_Shan02.prefab	Assets/Product/AssetRef/BigWorld/SkyGarden_LxyStoryLevel04/SceneObjectPrefabs/SG_Lxy04_JH_Shan02.asset
Assets/Product/BigWorld/SkyGarden_LxyStoryLevel04/SceneObjectPrefabs/SG_Lxy04_JH_Shan03.prefab	Assets/Product/AssetRef/BigWorld/SkyGarden_LxyStoryLevel04/SceneObjectPrefabs/SG_Lxy04_JH_Shan03.asset
Assets/Product/BigWorld/SkyGarden_LxyStoryLevel03/SceneObjectPrefabs/SG_Lxy03_JH_Daocaoren01.prefab	Assets/Product/AssetRef/BigWorld/SkyGarden_LxyStoryLevel03/SceneObjectPrefabs/SG_Lxy03_JH_Daocaoren01.asset
Assets/Product/BigWorld/SkyGarden_LxyStoryLevel03/SceneObjectPrefabs/SG_Lxy03_Ani_Fengche.prefab	Assets/Product/AssetRef/BigWorld/SkyGarden_LxyStoryLevel03/SceneObjectPrefabs/SG_Lxy03_Ani_Fengche.asset
Assets/Product/BigWorld/SkyGarden_LxyStoryLevel03/SceneObjectPrefabs/SG_Lxy03_JH_Fengche01.prefab	Assets/Product/AssetRef/BigWorld/SkyGarden_LxyStoryLevel03/SceneObjectPrefabs/SG_Lxy03_JH_Fengche01.asset
Assets/Product/BigWorld/SkyGarden_LxyStoryLevel03/SceneObjectPrefabs/SG_Lxy03_JH_Zhalan01.prefab	Assets/Product/AssetRef/BigWorld/SkyGarden_LxyStoryLevel03/SceneObjectPrefabs/SG_Lxy03_JH_Zhalan01.asset
Assets/Product/BigWorld/SkyGarden_LxyStoryLevel03/SceneObjectPrefabs/SG_Lxy03_JH_Fanzi01.prefab	Assets/Product/AssetRef/BigWorld/SkyGarden_LxyStoryLevel03/SceneObjectPrefabs/SG_Lxy03_JH_Fanzi01.asset
Assets/Product/BigWorld/SkyGarden/SceneObjectPrefabs/SG_Com_JH_004Zhuangzhi03.prefab	Assets/Product/AssetRef/BigWorld/SkyGarden/SceneObjectPrefabs/SG_Com_JH_004Zhuangzhi03.asset
Assets/Product/BigWorld/SkyGarden/SceneObjectPrefabs/SG_Com_JH_018Coffeecup_Ani.prefab	Assets/Product/AssetRef/BigWorld/SkyGarden/SceneObjectPrefabs/SG_Com_JH_018Coffeecup_Ani.asset
Assets/Product/BigWorld/SkyGarden_SuShe/SceneObjectPrefabs/SG_Sushe_JH_003Wujian03.prefab	Assets/Product/AssetRef/BigWorld/SkyGarden_SuShe/SceneObjectPrefabs/SG_Sushe_JH_003Wujian03.asset
Assets/Product/BigWorld/SkyGarden_SuShe/SceneObjectPrefabs/SG_Sushe_JH_003Wujian04.prefab	Assets/Product/AssetRef/BigWorld/SkyGarden_SuShe/SceneObjectPrefabs/SG_Sushe_JH_003Wujian04.asset
Assets/Product/BigWorld/SkyGarden_SuShe/SceneObjectPrefabs/SG_Sushe_JH_003Wujian05.prefab	Assets/Product/AssetRef/BigWorld/SkyGarden_SuShe/SceneObjectPrefabs/SG_Sushe_JH_003Wujian05.asset
Assets/Product/BigWorld/SkyGarden_SuShe/SceneObjectPrefabs/SG_Sushe_JH_003Wujian06.prefab	Assets/Product/AssetRef/BigWorld/SkyGarden_SuShe/SceneObjectPrefabs/SG_Sushe_JH_003Wujian06.asset
Assets/Product/BigWorld/SkyGarden_SuShe/SceneObjectPrefabs/SG_Sushe_JH_003Wujian07.prefab	Assets/Product/AssetRef/BigWorld/SkyGarden_SuShe/SceneObjectPrefabs/SG_Sushe_JH_003Wujian07.asset
Assets/Product/BigWorld/SkyGarden_SuShe/SceneObjectPrefabs/SG_Sushe_JH_003Wujian08.prefab	Assets/Product/AssetRef/BigWorld/SkyGarden_SuShe/SceneObjectPrefabs/SG_Sushe_JH_003Wujian08.asset
Assets/Product/BigWorld/SkyGarden_SuShe/SceneObjectPrefabs/SG_Sushe_JH_013Diy02.prefab	Assets/Product/AssetRef/BigWorld/SkyGarden_SuShe/SceneObjectPrefabs/SG_Sushe_JH_013Diy02.asset
Assets/Product/BigWorld/SkyGarden_SuShe/SceneObjectPrefabs/SG_Sushe_JH_013Diy01.prefab	Assets/Product/AssetRef/BigWorld/SkyGarden_SuShe/SceneObjectPrefabs/SG_Sushe_JH_013Diy01.asset
Assets/Product/BigWorld/SkyGarden_SuShe/SceneObjectPrefabs/SG_sushe_59aQingwa.prefab	Assets/Product/AssetRef/BigWorld/SkyGarden_SuShe/SceneObjectPrefabs/SG_sushe_59aQingwa.asset
Assets/Product/BigWorld/SkyGarden/StaticPrefabs/MG_Main_L0_X160_Y141.prefab	Assets/Product/AssetRef/BigWorld/SkyGarden/StaticPrefabs/MG_Main_L0_X160_Y141.asset
Assets/Product/BigWorld/SkyGarden/StaticPrefabs/MG_Main_L0_X160_Y140.prefab	Assets/Product/AssetRef/BigWorld/SkyGarden/StaticPrefabs/MG_Main_L0_X160_Y140.asset
Assets/Product/BigWorld/SkyGarden/StaticPrefabs/MG_Main_L0_X161_Y141.prefab	Assets/Product/AssetRef/BigWorld/SkyGarden/StaticPrefabs/MG_Main_L0_X161_Y141.asset
Assets/Product/BigWorld/SkyGarden/StaticPrefabs/MG_Main_L0_X161_Y142.prefab	Assets/Product/AssetRef/BigWorld/SkyGarden/StaticPrefabs/MG_Main_L0_X161_Y142.asset
Assets/Product/BigWorld/SkyGarden/StaticPrefabs/MG_Main_L0_X156_Y141.prefab	Assets/Product/AssetRef/BigWorld/SkyGarden/StaticPrefabs/MG_Main_L0_X156_Y141.asset
Assets/Product/BigWorld/SkyGarden/StaticPrefabs/MG_Main_L0_X157_Y141.prefab	Assets/Product/AssetRef/BigWorld/SkyGarden/StaticPrefabs/MG_Main_L0_X157_Y141.asset
Assets/Product/BigWorld/SkyGarden/StaticPrefabs/MG_Main_L0_X157_Y142.prefab	Assets/Product/AssetRef/BigWorld/SkyGarden/StaticPrefabs/MG_Main_L0_X157_Y142.asset
Assets/Product/BigWorld/SkyGarden/StaticPrefabs/MG_Main_L0_X155_Y141.prefab	Assets/Product/AssetRef/BigWorld/SkyGarden/StaticPrefabs/MG_Main_L0_X155_Y141.asset
Assets/Product/BigWorld/SkyGarden/StaticPrefabs/MG_Main_L0_X155_Y143.prefab	Assets/Product/AssetRef/BigWorld/SkyGarden/StaticPrefabs/MG_Main_L0_X155_Y143.asset
Assets/Product/BigWorld/SkyGarden/StaticPrefabs/MG_Main_L0_X157_Y140.prefab	Assets/Product/AssetRef/BigWorld/SkyGarden/StaticPrefabs/MG_Main_L0_X157_Y140.asset
Assets/Product/BigWorld/SkyGarden/StaticPrefabs/MG_Main_L0_X157_Y144.prefab	Assets/Product/AssetRef/BigWorld/SkyGarden/StaticPrefabs/MG_Main_L0_X157_Y144.asset
Assets/Product/BigWorld/SkyGarden/StaticPrefabs/MG_Main_L0_X156_Y144.prefab	Assets/Product/AssetRef/BigWorld/SkyGarden/StaticPrefabs/MG_Main_L0_X156_Y144.asset
Assets/Product/BigWorld/SkyGarden/StaticPrefabs/MG_Main_L0_X158_Y144.prefab	Assets/Product/AssetRef/BigWorld/SkyGarden/StaticPrefabs/MG_Main_L0_X158_Y144.asset
Assets/Product/BigWorld/SkyGarden/StaticPrefabs/MG_Main_L0_X156_Y145.prefab	Assets/Product/AssetRef/BigWorld/SkyGarden/StaticPrefabs/MG_Main_L0_X156_Y145.asset
Assets/Product/BigWorld/SkyGarden/StaticPrefabs/MG_Main_L0_X157_Y145.prefab	Assets/Product/AssetRef/BigWorld/SkyGarden/StaticPrefabs/MG_Main_L0_X157_Y145.asset
Assets/Product/BigWorld/SkyGarden/StaticPrefabs/MG_Main_L0_X154_Y143.prefab	Assets/Product/AssetRef/BigWorld/SkyGarden/StaticPrefabs/MG_Main_L0_X154_Y143.asset
Assets/Product/BigWorld/SkyGarden/StaticPrefabs/MG_Main_L0_X155_Y144.prefab	Assets/Product/AssetRef/BigWorld/SkyGarden/StaticPrefabs/MG_Main_L0_X155_Y144.asset
Assets/Product/BigWorld/SkyGarden/StaticPrefabs/MG_Main_L0_X156_Y142.prefab	Assets/Product/AssetRef/BigWorld/SkyGarden/StaticPrefabs/MG_Main_L0_X156_Y142.asset
Assets/Product/BigWorld/SkyGarden/StaticPrefabs/MG_Main_L0_X161_Y143.prefab	Assets/Product/AssetRef/BigWorld/SkyGarden/StaticPrefabs/MG_Main_L0_X161_Y143.asset
Assets/Product/BigWorld/SkyGarden/StaticPrefabs/MG_Main_L0_X160_Y142.prefab	Assets/Product/AssetRef/BigWorld/SkyGarden/StaticPrefabs/MG_Main_L0_X160_Y142.asset
Assets/Product/BigWorld/SkyGarden/StaticPrefabs/MG_Main_L0_X159_Y141.prefab	Assets/Product/AssetRef/BigWorld/SkyGarden/StaticPrefabs/MG_Main_L0_X159_Y141.asset
Assets/Product/BigWorld/SkyGarden/StaticPrefabs/MG_Main_L0_X158_Y143.prefab	Assets/Product/AssetRef/BigWorld/SkyGarden/StaticPrefabs/MG_Main_L0_X158_Y143.asset
Assets/Product/BigWorld/SkyGarden/StaticPrefabs/MG_Main_L0_X159_Y144.prefab	Assets/Product/AssetRef/BigWorld/SkyGarden/StaticPrefabs/MG_Main_L0_X159_Y144.asset
Assets/Product/BigWorld/SkyGarden/StaticPrefabs/MG_Main_L0_X160_Y143.prefab	Assets/Product/AssetRef/BigWorld/SkyGarden/StaticPrefabs/MG_Main_L0_X160_Y143.asset
Assets/Product/BigWorld/SkyGarden/StaticPrefabs/MG_Main_L0_X159_Y142.prefab	Assets/Product/AssetRef/BigWorld/SkyGarden/StaticPrefabs/MG_Main_L0_X159_Y142.asset
Assets/Product/BigWorld/SkyGarden/StaticPrefabs/MG_Main_L0_X159_Y140.prefab	Assets/Product/AssetRef/BigWorld/SkyGarden/StaticPrefabs/MG_Main_L0_X159_Y140.asset
Assets/Product/BigWorld/SkyGarden/StaticPrefabs/MG_Main_L0_X154_Y142.prefab	Assets/Product/AssetRef/BigWorld/SkyGarden/StaticPrefabs/MG_Main_L0_X154_Y142.asset
Assets/Product/BigWorld/SkyGarden/StaticPrefabs/MG_Main_L0_X156_Y140.prefab	Assets/Product/AssetRef/BigWorld/SkyGarden/StaticPrefabs/MG_Main_L0_X156_Y140.asset
Assets/Product/BigWorld/SkyGarden/StaticPrefabs/MG_Main_L0_X157_Y143.prefab	Assets/Product/AssetRef/BigWorld/SkyGarden/StaticPrefabs/MG_Main_L0_X157_Y143.asset
Assets/Product/BigWorld/SkyGarden/StaticPrefabs/MG_Main_L0_X159_Y143.prefab	Assets/Product/AssetRef/BigWorld/SkyGarden/StaticPrefabs/MG_Main_L0_X159_Y143.asset
Assets/Product/BigWorld/SkyGarden/StaticPrefabs/MG_Main_L0_X155_Y142.prefab	Assets/Product/AssetRef/BigWorld/SkyGarden/StaticPrefabs/MG_Main_L0_X155_Y142.asset
Assets/Product/BigWorld/SkyGarden/StaticPrefabs/MG_Main_L0_X156_Y143.prefab	Assets/Product/AssetRef/BigWorld/SkyGarden/StaticPrefabs/MG_Main_L0_X156_Y143.asset
Assets/Product/BigWorld/SkyGarden/StaticPrefabs/MG_Main_L0_X154_Y141.prefab	Assets/Product/AssetRef/BigWorld/SkyGarden/StaticPrefabs/MG_Main_L0_X154_Y141.asset
Assets/Product/BigWorld/SkyGarden/StaticPrefabs/MG_Main_L0_X155_Y140.prefab	Assets/Product/AssetRef/BigWorld/SkyGarden/StaticPrefabs/MG_Main_L0_X155_Y140.asset
Assets/Product/BigWorld/SkyGarden/StaticPrefabs/MG_Main_L0_X158_Y142.prefab	Assets/Product/AssetRef/BigWorld/SkyGarden/StaticPrefabs/MG_Main_L0_X158_Y142.asset
Assets/Product/BigWorld/SkyGarden/StaticPrefabs/MG_Main_L0_X154_Y144.prefab	Assets/Product/AssetRef/BigWorld/SkyGarden/StaticPrefabs/MG_Main_L0_X154_Y144.asset
Assets/Product/BigWorld/SkyGarden/StaticPrefabs/MG_Main_L0_X160_Y144.prefab	Assets/Product/AssetRef/BigWorld/SkyGarden/StaticPrefabs/MG_Main_L0_X160_Y144.asset
Assets/Product/BigWorld/SkyGarden/StaticPrefabs/MG_Main_L0_X161_Y140.prefab	Assets/Product/AssetRef/BigWorld/SkyGarden/StaticPrefabs/MG_Main_L0_X161_Y140.asset
Assets/Product/BigWorld/SkyGarden/StaticPrefabs/MG_Main_L0_X162_Y142.prefab	Assets/Product/AssetRef/BigWorld/SkyGarden/StaticPrefabs/MG_Main_L0_X162_Y142.asset
Assets/Product/BigWorld/SkyGarden/StaticPrefabs/MG_Main_L0_X153_Y142.prefab	Assets/Product/AssetRef/BigWorld/SkyGarden/StaticPrefabs/MG_Main_L0_X153_Y142.asset
Assets/Product/BigWorld/SkyGarden/StaticPrefabs/MG_Main_L1_X79_Y72.prefab	Assets/Product/AssetRef/BigWorld/SkyGarden/StaticPrefabs/MG_Main_L1_X79_Y72.asset
Assets/Product/BigWorld/SkyGarden/StaticPrefabs/MG_Main_L1_X77_Y71.prefab	Assets/Product/AssetRef/BigWorld/SkyGarden/StaticPrefabs/MG_Main_L1_X77_Y71.asset
Assets/Product/BigWorld/SkyGarden/StaticPrefabs/MG_Main_L1_X79_Y71.prefab	Assets/Product/AssetRef/BigWorld/SkyGarden/StaticPrefabs/MG_Main_L1_X79_Y71.asset
Assets/Product/BigWorld/SkyGarden/StaticPrefabs/MG_Main_L1_X78_Y72.prefab	Assets/Product/AssetRef/BigWorld/SkyGarden/StaticPrefabs/MG_Main_L1_X78_Y72.asset
Assets/Product/BigWorld/SkyGarden/StaticPrefabs/MG_Main_L1_X77_Y72.prefab	Assets/Product/AssetRef/BigWorld/SkyGarden/StaticPrefabs/MG_Main_L1_X77_Y72.asset
Assets/Product/BigWorld/SkyGarden/StaticPrefabs/MG_Main_L1_X78_Y70.prefab	Assets/Product/AssetRef/BigWorld/SkyGarden/StaticPrefabs/MG_Main_L1_X78_Y70.asset
Assets/Product/BigWorld/SkyGarden/StaticPrefabs/MG_Main_L1_X78_Y71.prefab	Assets/Product/AssetRef/BigWorld/SkyGarden/StaticPrefabs/MG_Main_L1_X78_Y71.asset
Assets/Product/BigWorld/SkyGarden/StaticPrefabs/MG_Main_L1_X80_Y71.prefab	Assets/Product/AssetRef/BigWorld/SkyGarden/StaticPrefabs/MG_Main_L1_X80_Y71.asset
Assets/Product/BigWorld/SkyGarden/StaticPrefabs/MG_Main_L2_X39_Y36.prefab	Assets/Product/AssetRef/BigWorld/SkyGarden/StaticPrefabs/MG_Main_L2_X39_Y36.asset
Assets/Product/BigWorld/SkyGarden/StaticPrefabs/MG_Main_L2_X39_Y35.prefab	Assets/Product/AssetRef/BigWorld/SkyGarden/StaticPrefabs/MG_Main_L2_X39_Y35.asset
Assets/Product/BigWorld/SkyGarden/StaticPrefabs/MG_Main_L5_X4_Y4.prefab	Assets/Product/AssetRef/BigWorld/SkyGarden/StaticPrefabs/MG_Main_L5_X4_Y4.asset
Assets/Product/BigWorld/SkyGarden/StaticPrefabs/MG_Main_L8_X0_Y0.prefab	Assets/Product/AssetRef/BigWorld/SkyGarden/StaticPrefabs/MG_Main_L8_X0_Y0.asset
Assets/Product/BigWorld/SkyGarden/StaticPrefabs/MG_Building_L0_X85_Y73.prefab	Assets/Product/AssetRef/BigWorld/SkyGarden/StaticPrefabs/MG_Building_L0_X85_Y73.asset
Assets/Product/BigWorld/SkyGarden/StaticPrefabs/MG_Building_L0_X86_Y73.prefab	Assets/Product/AssetRef/BigWorld/SkyGarden/StaticPrefabs/MG_Building_L0_X86_Y73.asset
Assets/Product/BigWorld/SkyGarden/StaticPrefabs/MG_Building_L0_X85_Y72.prefab	Assets/Product/AssetRef/BigWorld/SkyGarden/StaticPrefabs/MG_Building_L0_X85_Y72.asset
Assets/Product/BigWorld/SkyGarden/StaticPrefabs/MG_Building_L0_X83_Y71.prefab	Assets/Product/AssetRef/BigWorld/SkyGarden/StaticPrefabs/MG_Building_L0_X83_Y71.asset
Assets/Product/BigWorld/SkyGarden/StaticPrefabs/MG_Building_L0_X83_Y72.prefab	Assets/Product/AssetRef/BigWorld/SkyGarden/StaticPrefabs/MG_Building_L0_X83_Y72.asset
Assets/Product/BigWorld/SkyGarden/StaticPrefabs/MG_Building_L0_X84_Y74.prefab	Assets/Product/AssetRef/BigWorld/SkyGarden/StaticPrefabs/MG_Building_L0_X84_Y74.asset
Assets/Product/BigWorld/SkyGarden/StaticPrefabs/MG_Building_L0_X82_Y72.prefab	Assets/Product/AssetRef/BigWorld/SkyGarden/StaticPrefabs/MG_Building_L0_X82_Y72.asset
Assets/Product/BigWorld/SkyGarden/StaticPrefabs/MG_Building_L0_X85_Y75.prefab	Assets/Product/AssetRef/BigWorld/SkyGarden/StaticPrefabs/MG_Building_L0_X85_Y75.asset
Assets/Product/BigWorld/SkyGarden/StaticPrefabs/MG_Building_L0_X83_Y74.prefab	Assets/Product/AssetRef/BigWorld/SkyGarden/StaticPrefabs/MG_Building_L0_X83_Y74.asset
Assets/Product/BigWorld/SkyGarden/StaticPrefabs/MG_Building_L0_X83_Y73.prefab	Assets/Product/AssetRef/BigWorld/SkyGarden/StaticPrefabs/MG_Building_L0_X83_Y73.asset
Assets/Product/BigWorld/SkyGarden/StaticPrefabs/MG_Building_L0_X82_Y74.prefab	Assets/Product/AssetRef/BigWorld/SkyGarden/StaticPrefabs/MG_Building_L0_X82_Y74.asset
Assets/Product/BigWorld/SkyGarden/StaticPrefabs/MG_Building_L0_X82_Y73.prefab	Assets/Product/AssetRef/BigWorld/SkyGarden/StaticPrefabs/MG_Building_L0_X82_Y73.asset
Assets/Product/BigWorld/SkyGarden/StaticPrefabs/MG_Building_L0_X84_Y73.prefab	Assets/Product/AssetRef/BigWorld/SkyGarden/StaticPrefabs/MG_Building_L0_X84_Y73.asset
Assets/Product/BigWorld/SkyGarden/StaticPrefabs/MG_Building_L0_X83_Y75.prefab	Assets/Product/AssetRef/BigWorld/SkyGarden/StaticPrefabs/MG_Building_L0_X83_Y75.asset
Assets/Product/BigWorld/SkyGarden/StaticPrefabs/MG_Building_L0_X81_Y74.prefab	Assets/Product/AssetRef/BigWorld/SkyGarden/StaticPrefabs/MG_Building_L0_X81_Y74.asset
Assets/Product/BigWorld/SkyGarden/StaticPrefabs/MG_Building_L0_X85_Y74.prefab	Assets/Product/AssetRef/BigWorld/SkyGarden/StaticPrefabs/MG_Building_L0_X85_Y74.asset
Assets/Product/BigWorld/SkyGarden/StaticPrefabs/MG_Building_L0_X82_Y75.prefab	Assets/Product/AssetRef/BigWorld/SkyGarden/StaticPrefabs/MG_Building_L0_X82_Y75.asset
Assets/Product/BigWorld/SkyGarden/StaticPrefabs/MG_Building_L0_X81_Y73.prefab	Assets/Product/AssetRef/BigWorld/SkyGarden/StaticPrefabs/MG_Building_L0_X81_Y73.asset
Assets/Product/BigWorld/SkyGarden/StaticPrefabs/MG_Building_L1_X42_Y35.prefab	Assets/Product/AssetRef/BigWorld/SkyGarden/StaticPrefabs/MG_Building_L1_X42_Y35.asset
Assets/Product/BigWorld/SkyGarden/StaticPrefabs/MG_Building_L1_X44_Y41.prefab	Assets/Product/AssetRef/BigWorld/SkyGarden/StaticPrefabs/MG_Building_L1_X44_Y41.asset
Assets/Product/BigWorld/SkyGarden/StaticPrefabs/MG_Building_L1_X44_Y40.prefab	Assets/Product/AssetRef/BigWorld/SkyGarden/StaticPrefabs/MG_Building_L1_X44_Y40.asset
Assets/Product/BigWorld/SkyGarden/StaticPrefabs/MG_Building_L1_X44_Y39.prefab	Assets/Product/AssetRef/BigWorld/SkyGarden/StaticPrefabs/MG_Building_L1_X44_Y39.asset
Assets/Product/BigWorld/SkyGarden/StaticPrefabs/MG_Building_L1_X43_Y38.prefab	Assets/Product/AssetRef/BigWorld/SkyGarden/StaticPrefabs/MG_Building_L1_X43_Y38.asset
Assets/Product/BigWorld/SkyGarden/StaticPrefabs/MG_Building_L1_X42_Y38.prefab	Assets/Product/AssetRef/BigWorld/SkyGarden/StaticPrefabs/MG_Building_L1_X42_Y38.asset
Assets/Product/BigWorld/SkyGarden/StaticPrefabs/MG_Building_L1_X39_Y36.prefab	Assets/Product/AssetRef/BigWorld/SkyGarden/StaticPrefabs/MG_Building_L1_X39_Y36.asset
Assets/Product/BigWorld/SkyGarden/StaticPrefabs/MG_Building_L1_X40_Y37.prefab	Assets/Product/AssetRef/BigWorld/SkyGarden/StaticPrefabs/MG_Building_L1_X40_Y37.asset
Assets/Product/BigWorld/SkyGarden/StaticPrefabs/MG_Building_L1_X41_Y36.prefab	Assets/Product/AssetRef/BigWorld/SkyGarden/StaticPrefabs/MG_Building_L1_X41_Y36.asset
Assets/Product/BigWorld/SkyGarden/StaticPrefabs/MG_Building_L1_X42_Y37.prefab	Assets/Product/AssetRef/BigWorld/SkyGarden/StaticPrefabs/MG_Building_L1_X42_Y37.asset
Assets/Product/BigWorld/SkyGarden/StaticPrefabs/MG_Building_L1_X41_Y37.prefab	Assets/Product/AssetRef/BigWorld/SkyGarden/StaticPrefabs/MG_Building_L1_X41_Y37.asset
Assets/Product/BigWorld/SkyGarden/StaticPrefabs/MG_Building_L2_X21_Y18.prefab	Assets/Product/AssetRef/BigWorld/SkyGarden/StaticPrefabs/MG_Building_L2_X21_Y18.asset
Assets/Product/BigWorld/SkyGarden/StaticPrefabs/MG_Building_L2_X21_Y19.prefab	Assets/Product/AssetRef/BigWorld/SkyGarden/StaticPrefabs/MG_Building_L2_X21_Y19.asset
Assets/Product/BigWorld/SkyGarden/StaticPrefabs/MG_Building_L2_X22_Y19.prefab	Assets/Product/AssetRef/BigWorld/SkyGarden/StaticPrefabs/MG_Building_L2_X22_Y19.asset
Assets/Product/BigWorld/SkyGarden/StaticPrefabs/MG_Building_L2_X22_Y20.prefab	Assets/Product/AssetRef/BigWorld/SkyGarden/StaticPrefabs/MG_Building_L2_X22_Y20.asset
Assets/Product/BigWorld/SkyGarden/StaticPrefabs/MG_Building_L2_X21_Y20.prefab	Assets/Product/AssetRef/BigWorld/SkyGarden/StaticPrefabs/MG_Building_L2_X21_Y20.asset
Assets/Product/BigWorld/SkyGarden/StaticPrefabs/MG_Building_L2_X20_Y18.prefab	Assets/Product/AssetRef/BigWorld/SkyGarden/StaticPrefabs/MG_Building_L2_X20_Y18.asset
Assets/Product/BigWorld/SkyGarden/StaticPrefabs/MG_Building_L2_X19_Y18.prefab	Assets/Product/AssetRef/BigWorld/SkyGarden/StaticPrefabs/MG_Building_L2_X19_Y18.asset
Assets/Product/BigWorld/SkyGarden/StaticPrefabs/MG_Building_L3_X10_Y9.prefab	Assets/Product/AssetRef/BigWorld/SkyGarden/StaticPrefabs/MG_Building_L3_X10_Y9.asset
Assets/Product/BigWorld/SkyGarden/StaticPrefabs/MG_Building_L3_X10_Y10.prefab	Assets/Product/AssetRef/BigWorld/SkyGarden/StaticPrefabs/MG_Building_L3_X10_Y10.asset
Assets/Product/BigWorld/SkyGarden/StaticPrefabs/MG_Building_L5_X2_Y2.prefab	Assets/Product/AssetRef/BigWorld/SkyGarden/StaticPrefabs/MG_Building_L5_X2_Y2.asset
Assets/Product/BigWorld/SkyGarden/StaticPrefabs/MG_Building_L7_X0_Y0.prefab	Assets/Product/AssetRef/BigWorld/SkyGarden/StaticPrefabs/MG_Building_L7_X0_Y0.asset
Assets/Product/BigWorld/SkyGarden/StaticPrefabs/MG_Vegetation_L0_X160_Y141.prefab	Assets/Product/AssetRef/BigWorld/SkyGarden/StaticPrefabs/MG_Vegetation_L0_X160_Y141.asset
Assets/Product/BigWorld/SkyGarden/StaticPrefabs/MG_Vegetation_L0_X160_Y142.prefab	Assets/Product/AssetRef/BigWorld/SkyGarden/StaticPrefabs/MG_Vegetation_L0_X160_Y142.asset
Assets/Product/BigWorld/SkyGarden/StaticPrefabs/MG_Vegetation_L0_X159_Y141.prefab	Assets/Product/AssetRef/BigWorld/SkyGarden/StaticPrefabs/MG_Vegetation_L0_X159_Y141.asset
Assets/Product/BigWorld/SkyGarden/StaticPrefabs/MG_Vegetation_L0_X160_Y143.prefab	Assets/Product/AssetRef/BigWorld/SkyGarden/StaticPrefabs/MG_Vegetation_L0_X160_Y143.asset
Assets/Product/BigWorld/SkyGarden/StaticPrefabs/MG_Vegetation_L0_X161_Y141.prefab	Assets/Product/AssetRef/BigWorld/SkyGarden/StaticPrefabs/MG_Vegetation_L0_X161_Y141.asset
Assets/Product/BigWorld/SkyGarden/StaticPrefabs/MG_Vegetation_L0_X161_Y142.prefab	Assets/Product/AssetRef/BigWorld/SkyGarden/StaticPrefabs/MG_Vegetation_L0_X161_Y142.asset
Assets/Product/BigWorld/SkyGarden/StaticPrefabs/MG_Vegetation_L0_X161_Y143.prefab	Assets/Product/AssetRef/BigWorld/SkyGarden/StaticPrefabs/MG_Vegetation_L0_X161_Y143.asset
Assets/Product/BigWorld/SkyGarden/StaticPrefabs/MG_Vegetation_L0_X160_Y140.prefab	Assets/Product/AssetRef/BigWorld/SkyGarden/StaticPrefabs/MG_Vegetation_L0_X160_Y140.asset
Assets/Product/BigWorld/SkyGarden/StaticPrefabs/MG_Vegetation_L0_X162_Y142.prefab	Assets/Product/AssetRef/BigWorld/SkyGarden/StaticPrefabs/MG_Vegetation_L0_X162_Y142.asset
Assets/Product/BigWorld/SkyGarden/StaticPrefabs/MG_Vegetation_L0_X162_Y141.prefab	Assets/Product/AssetRef/BigWorld/SkyGarden/StaticPrefabs/MG_Vegetation_L0_X162_Y141.asset
Assets/Product/BigWorld/SkyGarden/StaticPrefabs/MG_Vegetation_L0_X161_Y140.prefab	Assets/Product/AssetRef/BigWorld/SkyGarden/StaticPrefabs/MG_Vegetation_L0_X161_Y140.asset
Assets/Product/BigWorld/SkyGarden/StaticPrefabs/MG_Vegetation_L0_X159_Y142.prefab	Assets/Product/AssetRef/BigWorld/SkyGarden/StaticPrefabs/MG_Vegetation_L0_X159_Y142.asset
Assets/Product/BigWorld/SkyGarden/StaticPrefabs/MG_Vegetation_L0_X128_Y128.prefab	Assets/Product/AssetRef/BigWorld/SkyGarden/StaticPrefabs/MG_Vegetation_L0_X128_Y128.asset
Assets/Product/BigWorld/SkyGarden/StaticPrefabs/MG_Vegetation_L0_X159_Y140.prefab	Assets/Product/AssetRef/BigWorld/SkyGarden/StaticPrefabs/MG_Vegetation_L0_X159_Y140.asset
Assets/Product/BigWorld/SkyGarden/StaticPrefabs/MG_Vegetation_L0_X157_Y145.prefab	Assets/Product/AssetRef/BigWorld/SkyGarden/StaticPrefabs/MG_Vegetation_L0_X157_Y145.asset
Assets/Product/BigWorld/SkyGarden/StaticPrefabs/MG_Vegetation_L0_X156_Y144.prefab	Assets/Product/AssetRef/BigWorld/SkyGarden/StaticPrefabs/MG_Vegetation_L0_X156_Y144.asset
Assets/Product/BigWorld/SkyGarden/StaticPrefabs/MG_Vegetation_L0_X157_Y144.prefab	Assets/Product/AssetRef/BigWorld/SkyGarden/StaticPrefabs/MG_Vegetation_L0_X157_Y144.asset
Assets/Product/BigWorld/SkyGarden/StaticPrefabs/MG_Vegetation_L0_X156_Y145.prefab	Assets/Product/AssetRef/BigWorld/SkyGarden/StaticPrefabs/MG_Vegetation_L0_X156_Y145.asset
Assets/Product/BigWorld/SkyGarden/StaticPrefabs/MG_Vegetation_L0_X155_Y143.prefab	Assets/Product/AssetRef/BigWorld/SkyGarden/StaticPrefabs/MG_Vegetation_L0_X155_Y143.asset
Assets/Product/BigWorld/SkyGarden/StaticPrefabs/MG_Vegetation_L0_X156_Y143.prefab	Assets/Product/AssetRef/BigWorld/SkyGarden/StaticPrefabs/MG_Vegetation_L0_X156_Y143.asset
Assets/Product/BigWorld/SkyGarden/StaticPrefabs/MG_Vegetation_L0_X155_Y142.prefab	Assets/Product/AssetRef/BigWorld/SkyGarden/StaticPrefabs/MG_Vegetation_L0_X155_Y142.asset
Assets/Product/BigWorld/SkyGarden/StaticPrefabs/MG_Vegetation_L0_X159_Y144.prefab	Assets/Product/AssetRef/BigWorld/SkyGarden/StaticPrefabs/MG_Vegetation_L0_X159_Y144.asset
Assets/Product/BigWorld/SkyGarden/StaticPrefabs/MG_Vegetation_L0_X157_Y143.prefab	Assets/Product/AssetRef/BigWorld/SkyGarden/StaticPrefabs/MG_Vegetation_L0_X157_Y143.asset
Assets/Product/BigWorld/SkyGarden/StaticPrefabs/MG_Vegetation_L0_X156_Y141.prefab	Assets/Product/AssetRef/BigWorld/SkyGarden/StaticPrefabs/MG_Vegetation_L0_X156_Y141.asset
Assets/Product/BigWorld/SkyGarden/StaticPrefabs/MG_Vegetation_L0_X156_Y142.prefab	Assets/Product/AssetRef/BigWorld/SkyGarden/StaticPrefabs/MG_Vegetation_L0_X156_Y142.asset
Assets/Product/BigWorld/SkyGarden/StaticPrefabs/MG_Vegetation_L0_X158_Y144.prefab	Assets/Product/AssetRef/BigWorld/SkyGarden/StaticPrefabs/MG_Vegetation_L0_X158_Y144.asset
Assets/Product/BigWorld/SkyGarden/StaticPrefabs/MG_Vegetation_L0_X158_Y143.prefab	Assets/Product/AssetRef/BigWorld/SkyGarden/StaticPrefabs/MG_Vegetation_L0_X158_Y143.asset
Assets/Product/BigWorld/SkyGarden/StaticPrefabs/MG_Vegetation_L0_X155_Y144.prefab	Assets/Product/AssetRef/BigWorld/SkyGarden/StaticPrefabs/MG_Vegetation_L0_X155_Y144.asset
Assets/Product/BigWorld/SkyGarden/StaticPrefabs/MG_Vegetation_L0_X154_Y143.prefab	Assets/Product/AssetRef/BigWorld/SkyGarden/StaticPrefabs/MG_Vegetation_L0_X154_Y143.asset
Assets/Product/BigWorld/SkyGarden/StaticPrefabs/MG_Vegetation_L0_X157_Y142.prefab	Assets/Product/AssetRef/BigWorld/SkyGarden/StaticPrefabs/MG_Vegetation_L0_X157_Y142.asset
Assets/Product/BigWorld/SkyGarden/StaticPrefabs/MG_Vegetation_L0_X153_Y142.prefab	Assets/Product/AssetRef/BigWorld/SkyGarden/StaticPrefabs/MG_Vegetation_L0_X153_Y142.asset
Assets/Product/BigWorld/SkyGarden/StaticPrefabs/MG_Vegetation_L0_X154_Y142.prefab	Assets/Product/AssetRef/BigWorld/SkyGarden/StaticPrefabs/MG_Vegetation_L0_X154_Y142.asset
Assets/Product/BigWorld/SkyGarden/StaticPrefabs/MG_Vegetation_L0_X155_Y141.prefab	Assets/Product/AssetRef/BigWorld/SkyGarden/StaticPrefabs/MG_Vegetation_L0_X155_Y141.asset
Assets/Product/BigWorld/SkyGarden/StaticPrefabs/MG_Vegetation_L0_X154_Y144.prefab	Assets/Product/AssetRef/BigWorld/SkyGarden/StaticPrefabs/MG_Vegetation_L0_X154_Y144.asset
Assets/Product/BigWorld/SkyGarden/StaticPrefabs/MG_Vegetation_L0_X159_Y143.prefab	Assets/Product/AssetRef/BigWorld/SkyGarden/StaticPrefabs/MG_Vegetation_L0_X159_Y143.asset
Assets/Product/BigWorld/SkyGarden/StaticPrefabs/MG_Vegetation_L0_X157_Y141.prefab	Assets/Product/AssetRef/BigWorld/SkyGarden/StaticPrefabs/MG_Vegetation_L0_X157_Y141.asset
Assets/Product/BigWorld/SkyGarden/StaticPrefabs/MG_Vegetation_L0_X156_Y140.prefab	Assets/Product/AssetRef/BigWorld/SkyGarden/StaticPrefabs/MG_Vegetation_L0_X156_Y140.asset
Assets/Product/BigWorld/SkyGarden/StaticPrefabs/MG_Vegetation_L0_X157_Y140.prefab	Assets/Product/AssetRef/BigWorld/SkyGarden/StaticPrefabs/MG_Vegetation_L0_X157_Y140.asset
Assets/Product/BigWorld/SkyGarden/StaticPrefabs/MG_Vegetation_L0_X155_Y140.prefab	Assets/Product/AssetRef/BigWorld/SkyGarden/StaticPrefabs/MG_Vegetation_L0_X155_Y140.asset
Assets/Product/BigWorld/SkyGarden/StaticPrefabs/MG_Vegetation_L0_X153_Y141.prefab	Assets/Product/AssetRef/BigWorld/SkyGarden/StaticPrefabs/MG_Vegetation_L0_X153_Y141.asset
Assets/Product/BigWorld/SkyGarden/StaticPrefabs/MG_Vegetation_L0_X158_Y142.prefab	Assets/Product/AssetRef/BigWorld/SkyGarden/StaticPrefabs/MG_Vegetation_L0_X158_Y142.asset
Assets/Product/BigWorld/SkyGarden/StaticPrefabs/MG_Vegetation_L0_X160_Y144.prefab	Assets/Product/AssetRef/BigWorld/SkyGarden/StaticPrefabs/MG_Vegetation_L0_X160_Y144.asset
Assets/Product/BigWorld/SkyGarden/StaticPrefabs/MG_Vegetation_L0_X153_Y143.prefab	Assets/Product/AssetRef/BigWorld/SkyGarden/StaticPrefabs/MG_Vegetation_L0_X153_Y143.asset
Assets/Product/BigWorld/SkyGarden/StaticPrefabs/MG_Tree_L0_X153_Y139.prefab	Assets/Product/AssetRef/BigWorld/SkyGarden/StaticPrefabs/MG_Tree_L0_X153_Y139.asset
Assets/Product/BigWorld/SkyGarden/StaticPrefabs/MG_Tree_L0_X154_Y140.prefab	Assets/Product/AssetRef/BigWorld/SkyGarden/StaticPrefabs/MG_Tree_L0_X154_Y140.asset
Assets/Product/BigWorld/SkyGarden/StaticPrefabs/MG_Tree_L0_X152_Y142.prefab	Assets/Product/AssetRef/BigWorld/SkyGarden/StaticPrefabs/MG_Tree_L0_X152_Y142.asset
Assets/Product/BigWorld/SkyGarden/StaticPrefabs/MG_Tree_L0_X153_Y142.prefab	Assets/Product/AssetRef/BigWorld/SkyGarden/StaticPrefabs/MG_Tree_L0_X153_Y142.asset
Assets/Product/BigWorld/SkyGarden/StaticPrefabs/MG_Tree_L0_X153_Y143.prefab	Assets/Product/AssetRef/BigWorld/SkyGarden/StaticPrefabs/MG_Tree_L0_X153_Y143.asset
Assets/Product/BigWorld/SkyGarden/StaticPrefabs/MG_Tree_L0_X155_Y141.prefab	Assets/Product/AssetRef/BigWorld/SkyGarden/StaticPrefabs/MG_Tree_L0_X155_Y141.asset
Assets/Product/BigWorld/SkyGarden/StaticPrefabs/MG_Tree_L0_X155_Y142.prefab	Assets/Product/AssetRef/BigWorld/SkyGarden/StaticPrefabs/MG_Tree_L0_X155_Y142.asset
Assets/Product/BigWorld/SkyGarden/StaticPrefabs/MG_Tree_L0_X156_Y142.prefab	Assets/Product/AssetRef/BigWorld/SkyGarden/StaticPrefabs/MG_Tree_L0_X156_Y142.asset
Assets/Product/BigWorld/SkyGarden/StaticPrefabs/MG_Tree_L0_X153_Y141.prefab	Assets/Product/AssetRef/BigWorld/SkyGarden/StaticPrefabs/MG_Tree_L0_X153_Y141.asset
Assets/Product/BigWorld/SkyGarden/StaticPrefabs/MG_Tree_L0_X152_Y141.prefab	Assets/Product/AssetRef/BigWorld/SkyGarden/StaticPrefabs/MG_Tree_L0_X152_Y141.asset
Assets/Product/BigWorld/SkyGarden/StaticPrefabs/MG_Tree_L0_X151_Y141.prefab	Assets/Product/AssetRef/BigWorld/SkyGarden/StaticPrefabs/MG_Tree_L0_X151_Y141.asset
Assets/Product/BigWorld/SkyGarden/StaticPrefabs/MG_Tree_L0_X157_Y140.prefab	Assets/Product/AssetRef/BigWorld/SkyGarden/StaticPrefabs/MG_Tree_L0_X157_Y140.asset
Assets/Product/BigWorld/SkyGarden/StaticPrefabs/MG_Tree_L0_X157_Y141.prefab	Assets/Product/AssetRef/BigWorld/SkyGarden/StaticPrefabs/MG_Tree_L0_X157_Y141.asset
Assets/Product/BigWorld/SkyGarden/StaticPrefabs/MG_Tree_L0_X158_Y143.prefab	Assets/Product/AssetRef/BigWorld/SkyGarden/StaticPrefabs/MG_Tree_L0_X158_Y143.asset
Assets/Product/BigWorld/SkyGarden/StaticPrefabs/MG_Tree_L0_X159_Y144.prefab	Assets/Product/AssetRef/BigWorld/SkyGarden/StaticPrefabs/MG_Tree_L0_X159_Y144.asset
Assets/Product/BigWorld/SkyGarden/StaticPrefabs/MG_Tree_L0_X159_Y145.prefab	Assets/Product/AssetRef/BigWorld/SkyGarden/StaticPrefabs/MG_Tree_L0_X159_Y145.asset
Assets/Product/BigWorld/SkyGarden/StaticPrefabs/MG_Tree_L0_X159_Y143.prefab	Assets/Product/AssetRef/BigWorld/SkyGarden/StaticPrefabs/MG_Tree_L0_X159_Y143.asset
Assets/Product/BigWorld/SkyGarden/StaticPrefabs/MG_Tree_L0_X158_Y142.prefab	Assets/Product/AssetRef/BigWorld/SkyGarden/StaticPrefabs/MG_Tree_L0_X158_Y142.asset
Assets/Product/BigWorld/SkyGarden/StaticPrefabs/MG_Tree_L0_X161_Y145.prefab	Assets/Product/AssetRef/BigWorld/SkyGarden/StaticPrefabs/MG_Tree_L0_X161_Y145.asset
Assets/Product/BigWorld/SkyGarden/StaticPrefabs/MG_Tree_L0_X160_Y143.prefab	Assets/Product/AssetRef/BigWorld/SkyGarden/StaticPrefabs/MG_Tree_L0_X160_Y143.asset
Assets/Product/BigWorld/SkyGarden/StaticPrefabs/MG_Tree_L0_X159_Y142.prefab	Assets/Product/AssetRef/BigWorld/SkyGarden/StaticPrefabs/MG_Tree_L0_X159_Y142.asset
Assets/Product/BigWorld/SkyGarden/StaticPrefabs/MG_Tree_L0_X160_Y142.prefab	Assets/Product/AssetRef/BigWorld/SkyGarden/StaticPrefabs/MG_Tree_L0_X160_Y142.asset
Assets/Product/BigWorld/SkyGarden/StaticPrefabs/MG_Tree_L0_X161_Y144.prefab	Assets/Product/AssetRef/BigWorld/SkyGarden/StaticPrefabs/MG_Tree_L0_X161_Y144.asset
Assets/Product/BigWorld/SkyGarden/StaticPrefabs/MG_Tree_L0_X160_Y144.prefab	Assets/Product/AssetRef/BigWorld/SkyGarden/StaticPrefabs/MG_Tree_L0_X160_Y144.asset
Assets/Product/BigWorld/SkyGarden/StaticPrefabs/MG_Tree_L0_X159_Y146.prefab	Assets/Product/AssetRef/BigWorld/SkyGarden/StaticPrefabs/MG_Tree_L0_X159_Y146.asset
Assets/Product/BigWorld/SkyGarden/StaticPrefabs/MG_Tree_L0_X158_Y141.prefab	Assets/Product/AssetRef/BigWorld/SkyGarden/StaticPrefabs/MG_Tree_L0_X158_Y141.asset
Assets/Product/BigWorld/SkyGarden/StaticPrefabs/MG_Tree_L0_X157_Y142.prefab	Assets/Product/AssetRef/BigWorld/SkyGarden/StaticPrefabs/MG_Tree_L0_X157_Y142.asset
Assets/Product/BigWorld/SkyGarden/StaticPrefabs/MG_Tree_L0_X157_Y143.prefab	Assets/Product/AssetRef/BigWorld/SkyGarden/StaticPrefabs/MG_Tree_L0_X157_Y143.asset
Assets/Product/BigWorld/SkyGarden/StaticPrefabs/MG_Tree_L0_X158_Y144.prefab	Assets/Product/AssetRef/BigWorld/SkyGarden/StaticPrefabs/MG_Tree_L0_X158_Y144.asset
Assets/Product/BigWorld/SkyGarden/StaticPrefabs/MG_Tree_L0_X156_Y141.prefab	Assets/Product/AssetRef/BigWorld/SkyGarden/StaticPrefabs/MG_Tree_L0_X156_Y141.asset
Assets/Product/BigWorld/SkyGarden/StaticPrefabs/MG_Tree_L0_X154_Y139.prefab	Assets/Product/AssetRef/BigWorld/SkyGarden/StaticPrefabs/MG_Tree_L0_X154_Y139.asset
Assets/Product/BigWorld/SkyGarden/StaticPrefabs/MG_Tree_L0_X154_Y142.prefab	Assets/Product/AssetRef/BigWorld/SkyGarden/StaticPrefabs/MG_Tree_L0_X154_Y142.asset
Assets/Product/BigWorld/SkyGarden/StaticPrefabs/MG_Tree_L0_X154_Y143.prefab	Assets/Product/AssetRef/BigWorld/SkyGarden/StaticPrefabs/MG_Tree_L0_X154_Y143.asset
Assets/Product/BigWorld/SkyGarden/StaticPrefabs/MG_Tree_L0_X155_Y143.prefab	Assets/Product/AssetRef/BigWorld/SkyGarden/StaticPrefabs/MG_Tree_L0_X155_Y143.asset
Assets/Product/BigWorld/SkyGarden/StaticPrefabs/MG_Tree_L0_X151_Y142.prefab	Assets/Product/AssetRef/BigWorld/SkyGarden/StaticPrefabs/MG_Tree_L0_X151_Y142.asset
Assets/Product/BigWorld/SkyGarden/StaticPrefabs/MG_Tree_L0_X154_Y141.prefab	Assets/Product/AssetRef/BigWorld/SkyGarden/StaticPrefabs/MG_Tree_L0_X154_Y141.asset
Assets/Product/BigWorld/SkyGarden/StaticPrefabs/MG_Tree_L1_X77_Y71.prefab	Assets/Product/AssetRef/BigWorld/SkyGarden/StaticPrefabs/MG_Tree_L1_X77_Y71.asset
Assets/Product/BigWorld/SkyGarden/StaticPrefabs/MG_Tree_L2_X38_Y35.prefab	Assets/Product/AssetRef/BigWorld/SkyGarden/StaticPrefabs/MG_Tree_L2_X38_Y35.asset
Assets/Product/BigWorld/SkyGarden/StaticPrefabs/MG_Ground_L0_X81_Y74.prefab	Assets/Product/AssetRef/BigWorld/SkyGarden/StaticPrefabs/MG_Ground_L0_X81_Y74.asset
Assets/Product/BigWorld/SkyGarden/StaticPrefabs/MG_Ground_L7_X0_Y0.prefab	Assets/Product/AssetRef/BigWorld/SkyGarden/StaticPrefabs/MG_Ground_L7_X0_Y0.asset
Assets/Product/BigWorld/SkyGarden/StaticPrefabs/MG_Volume_L1_X83_Y75.prefab	Assets/Product/AssetRef/BigWorld/SkyGarden/StaticPrefabs/MG_Volume_L1_X83_Y75.asset
Assets/Product/BigWorld/SkyGarden/StaticPrefabs/MG_BuildingMiddle_L0_X85_Y73.prefab	Assets/Product/AssetRef/BigWorld/SkyGarden/StaticPrefabs/MG_BuildingMiddle_L0_X85_Y73.asset
Assets/Product/BigWorld/SkyGarden/StaticPrefabs/MG_BuildingMiddle_L0_X82_Y73.prefab	Assets/Product/AssetRef/BigWorld/SkyGarden/StaticPrefabs/MG_BuildingMiddle_L0_X82_Y73.asset
Assets/Product/BigWorld/SkyGarden/StaticPrefabs/MG_BuildingMiddle_L0_X82_Y72.prefab	Assets/Product/AssetRef/BigWorld/SkyGarden/StaticPrefabs/MG_BuildingMiddle_L0_X82_Y72.asset
Assets/Product/BigWorld/SkyGarden/StaticPrefabs/MG_BuildingMiddle_L0_X83_Y73.prefab	Assets/Product/AssetRef/BigWorld/SkyGarden/StaticPrefabs/MG_BuildingMiddle_L0_X83_Y73.asset
Assets/Product/BigWorld/SkyGarden/StaticPrefabs/MG_BuildingMiddle_L0_X81_Y73.prefab	Assets/Product/AssetRef/BigWorld/SkyGarden/StaticPrefabs/MG_BuildingMiddle_L0_X81_Y73.asset
Assets/Product/BigWorld/SkyGarden/StaticPrefabs/MG_BuildingMiddle_L0_X83_Y74.prefab	Assets/Product/AssetRef/BigWorld/SkyGarden/StaticPrefabs/MG_BuildingMiddle_L0_X83_Y74.asset
Assets/Product/BigWorld/SkyGarden/StaticPrefabs/MG_BuildingMiddle_L0_X81_Y74.prefab	Assets/Product/AssetRef/BigWorld/SkyGarden/StaticPrefabs/MG_BuildingMiddle_L0_X81_Y74.asset
Assets/Product/BigWorld/SkyGarden/StaticPrefabs/MG_BuildingMiddle_L0_X82_Y74.prefab	Assets/Product/AssetRef/BigWorld/SkyGarden/StaticPrefabs/MG_BuildingMiddle_L0_X82_Y74.asset
Assets/Product/BigWorld/SkyGarden/StaticPrefabs/MG_BuildingMiddle_L0_X80_Y73.prefab	Assets/Product/AssetRef/BigWorld/SkyGarden/StaticPrefabs/MG_BuildingMiddle_L0_X80_Y73.asset
Assets/Product/BigWorld/SkyGarden/StaticPrefabs/MG_BuildingMiddle_L0_X84_Y73.prefab	Assets/Product/AssetRef/BigWorld/SkyGarden/StaticPrefabs/MG_BuildingMiddle_L0_X84_Y73.asset
Assets/Product/BigWorld/SkyGarden/StaticPrefabs/MG_BuildingMiddle_L0_X84_Y74.prefab	Assets/Product/AssetRef/BigWorld/SkyGarden/StaticPrefabs/MG_BuildingMiddle_L0_X84_Y74.asset
Assets/Product/BigWorld/SkyGarden/StaticPrefabs/MG_BuildingMiddle_L0_X86_Y72.prefab	Assets/Product/AssetRef/BigWorld/SkyGarden/StaticPrefabs/MG_BuildingMiddle_L0_X86_Y72.asset
Assets/Product/BigWorld/SkyGarden/StaticPrefabs/MG_BuildingMiddle_L0_X85_Y72.prefab	Assets/Product/AssetRef/BigWorld/SkyGarden/StaticPrefabs/MG_BuildingMiddle_L0_X85_Y72.asset
Assets/Product/BigWorld/SkyGarden/StaticPrefabs/MG_BuildingMiddle_L0_X83_Y72.prefab	Assets/Product/AssetRef/BigWorld/SkyGarden/StaticPrefabs/MG_BuildingMiddle_L0_X83_Y72.asset
Assets/Product/BigWorld/SkyGarden/StaticPrefabs/MG_BuildingMiddle_L0_X81_Y72.prefab	Assets/Product/AssetRef/BigWorld/SkyGarden/StaticPrefabs/MG_BuildingMiddle_L0_X81_Y72.asset
Assets/Product/BigWorld/SkyGarden/StaticPrefabs/MG_BuildingMiddle_L0_X80_Y72.prefab	Assets/Product/AssetRef/BigWorld/SkyGarden/StaticPrefabs/MG_BuildingMiddle_L0_X80_Y72.asset
Assets/Product/BigWorld/SkyGarden/StaticPrefabs/MG_BuildingMiddle_L0_X83_Y75.prefab	Assets/Product/AssetRef/BigWorld/SkyGarden/StaticPrefabs/MG_BuildingMiddle_L0_X83_Y75.asset
Assets/Product/BigWorld/SkyGarden/StaticPrefabs/MG_BuildingMiddle_L0_X85_Y74.prefab	Assets/Product/AssetRef/BigWorld/SkyGarden/StaticPrefabs/MG_BuildingMiddle_L0_X85_Y74.asset
Assets/Product/BigWorld/SkyGarden/StaticPrefabs/MG_BuildingMiddle_L0_X81_Y75.prefab	Assets/Product/AssetRef/BigWorld/SkyGarden/StaticPrefabs/MG_BuildingMiddle_L0_X81_Y75.asset
Assets/Product/BigWorld/SkyGarden/StaticPrefabs/MG_BuildingMiddle_L0_X82_Y75.prefab	Assets/Product/AssetRef/BigWorld/SkyGarden/StaticPrefabs/MG_BuildingMiddle_L0_X82_Y75.asset
Assets/Product/BigWorld/SkyGarden/StaticPrefabs/MG_BuildingMiddle_L1_X41_Y36.prefab	Assets/Product/AssetRef/BigWorld/SkyGarden/StaticPrefabs/MG_BuildingMiddle_L1_X41_Y36.asset
Assets/Product/BigWorld/SkyGarden/StaticPrefabs/MG_BuildingMiddle_L1_X41_Y37.prefab	Assets/Product/AssetRef/BigWorld/SkyGarden/StaticPrefabs/MG_BuildingMiddle_L1_X41_Y37.asset
Assets/Product/BigWorld/SkyGarden/StaticPrefabs/MG_BuildingMiddle_L1_X42_Y37.prefab	Assets/Product/AssetRef/BigWorld/SkyGarden/StaticPrefabs/MG_BuildingMiddle_L1_X42_Y37.asset
Assets/Product/BigWorld/SkyGarden/StaticPrefabs/MG_BuildingMiddle_L7_X0_Y0.prefab	Assets/Product/AssetRef/BigWorld/SkyGarden/StaticPrefabs/MG_BuildingMiddle_L7_X0_Y0.asset
Assets/Product/BigWorld/SkyGarden/StaticPrefabs/MG_HighProps_L0_X153_Y142.prefab	Assets/Product/AssetRef/BigWorld/SkyGarden/StaticPrefabs/MG_HighProps_L0_X153_Y142.asset
Assets/Product/BigWorld/SkyGarden/StaticPrefabs/MG_HighProps_L0_X158_Y141.prefab	Assets/Product/AssetRef/BigWorld/SkyGarden/StaticPrefabs/MG_HighProps_L0_X158_Y141.asset
Assets/Product/BigWorld/SkyGarden/StaticPrefabs/MG_HighProps_L0_X158_Y140.prefab	Assets/Product/AssetRef/BigWorld/SkyGarden/StaticPrefabs/MG_HighProps_L0_X158_Y140.asset
Assets/Product/BigWorld/SkyGarden/StaticPrefabs/MG_HighProps_L0_X157_Y139.prefab	Assets/Product/AssetRef/BigWorld/SkyGarden/StaticPrefabs/MG_HighProps_L0_X157_Y139.asset
Assets/Product/BigWorld/SkyGarden/StaticPrefabs/MG_HighProps_L0_X156_Y140.prefab	Assets/Product/AssetRef/BigWorld/SkyGarden/StaticPrefabs/MG_HighProps_L0_X156_Y140.asset
Assets/Product/BigWorld/SkyGarden/StaticPrefabs/MG_HighProps_L0_X159_Y140.prefab	Assets/Product/AssetRef/BigWorld/SkyGarden/StaticPrefabs/MG_HighProps_L0_X159_Y140.asset
Assets/Product/BigWorld/SkyGarden/StaticPrefabs/MG_HighProps_L0_X158_Y139.prefab	Assets/Product/AssetRef/BigWorld/SkyGarden/StaticPrefabs/MG_HighProps_L0_X158_Y139.asset
Assets/Product/BigWorld/SkyGarden/StaticPrefabs/MG_HighProps_L0_X159_Y139.prefab	Assets/Product/AssetRef/BigWorld/SkyGarden/StaticPrefabs/MG_HighProps_L0_X159_Y139.asset
Assets/Product/BigWorld/SkyGarden/StaticPrefabs/MG_HighProps_L0_X159_Y141.prefab	Assets/Product/AssetRef/BigWorld/SkyGarden/StaticPrefabs/MG_HighProps_L0_X159_Y141.asset
Assets/Product/BigWorld/SkyGarden/StaticPrefabs/MG_HighProps_L0_X157_Y141.prefab	Assets/Product/AssetRef/BigWorld/SkyGarden/StaticPrefabs/MG_HighProps_L0_X157_Y141.asset
Assets/Product/BigWorld/SkyGarden/StaticPrefabs/MG_HighProps_L0_X156_Y139.prefab	Assets/Product/AssetRef/BigWorld/SkyGarden/StaticPrefabs/MG_HighProps_L0_X156_Y139.asset
Assets/Product/BigWorld/SkyGarden/StaticPrefabs/MG_HighProps_L0_X157_Y140.prefab	Assets/Product/AssetRef/BigWorld/SkyGarden/StaticPrefabs/MG_HighProps_L0_X157_Y140.asset
Assets/Product/BigWorld/SkyGarden/StaticPrefabs/MG_HighProps_L0_X153_Y140.prefab	Assets/Product/AssetRef/BigWorld/SkyGarden/StaticPrefabs/MG_HighProps_L0_X153_Y140.asset
Assets/Product/BigWorld/SkyGarden/StaticPrefabs/MG_HighProps_L0_X154_Y140.prefab	Assets/Product/AssetRef/BigWorld/SkyGarden/StaticPrefabs/MG_HighProps_L0_X154_Y140.asset
Assets/Product/BigWorld/SkyGarden/StaticPrefabs/MG_HighProps_L0_X156_Y142.prefab	Assets/Product/AssetRef/BigWorld/SkyGarden/StaticPrefabs/MG_HighProps_L0_X156_Y142.asset
Assets/Product/BigWorld/SkyGarden/StaticPrefabs/MG_HighProps_L0_X152_Y141.prefab	Assets/Product/AssetRef/BigWorld/SkyGarden/StaticPrefabs/MG_HighProps_L0_X152_Y141.asset
Assets/Product/BigWorld/SkyGarden/StaticPrefabs/MG_HighProps_L0_X154_Y141.prefab	Assets/Product/AssetRef/BigWorld/SkyGarden/StaticPrefabs/MG_HighProps_L0_X154_Y141.asset
Assets/Product/BigWorld/SkyGarden/StaticPrefabs/MG_HighProps_L0_X152_Y140.prefab	Assets/Product/AssetRef/BigWorld/SkyGarden/StaticPrefabs/MG_HighProps_L0_X152_Y140.asset
Assets/Product/BigWorld/SkyGarden/StaticPrefabs/MG_HighProps_L0_X155_Y142.prefab	Assets/Product/AssetRef/BigWorld/SkyGarden/StaticPrefabs/MG_HighProps_L0_X155_Y142.asset
Assets/Product/BigWorld/SkyGarden/StaticPrefabs/MG_HighProps_L0_X154_Y142.prefab	Assets/Product/AssetRef/BigWorld/SkyGarden/StaticPrefabs/MG_HighProps_L0_X154_Y142.asset
Assets/Product/BigWorld/SkyGarden/StaticPrefabs/MG_HighProps_L0_X155_Y141.prefab	Assets/Product/AssetRef/BigWorld/SkyGarden/StaticPrefabs/MG_HighProps_L0_X155_Y141.asset
Assets/Product/BigWorld/SkyGarden/StaticPrefabs/MG_HighProps_L0_X152_Y142.prefab	Assets/Product/AssetRef/BigWorld/SkyGarden/StaticPrefabs/MG_HighProps_L0_X152_Y142.asset
Assets/Product/BigWorld/SkyGarden/StaticPrefabs/MG_HighProps_L0_X153_Y141.prefab	Assets/Product/AssetRef/BigWorld/SkyGarden/StaticPrefabs/MG_HighProps_L0_X153_Y141.asset
Assets/Product/BigWorld/SkyGarden/StaticPrefabs/MG_HighProps_L0_X157_Y142.prefab	Assets/Product/AssetRef/BigWorld/SkyGarden/StaticPrefabs/MG_HighProps_L0_X157_Y142.asset
Assets/Product/BigWorld/SkyGarden/StaticPrefabs/MG_HighProps_L0_X156_Y141.prefab	Assets/Product/AssetRef/BigWorld/SkyGarden/StaticPrefabs/MG_HighProps_L0_X156_Y141.asset
Assets/Product/BigWorld/SkyGarden/StaticPrefabs/MG_HighProps_L0_X154_Y143.prefab	Assets/Product/AssetRef/BigWorld/SkyGarden/StaticPrefabs/MG_HighProps_L0_X154_Y143.asset
Assets/Product/BigWorld/SkyGarden/StaticPrefabs/MG_HighProps_L0_X153_Y143.prefab	Assets/Product/AssetRef/BigWorld/SkyGarden/StaticPrefabs/MG_HighProps_L0_X153_Y143.asset
Assets/Product/BigWorld/SkyGarden/StaticPrefabs/MG_HighProps_L0_X155_Y143.prefab	Assets/Product/AssetRef/BigWorld/SkyGarden/StaticPrefabs/MG_HighProps_L0_X155_Y143.asset
Assets/Product/BigWorld/SkyGarden_JumpPlayer/StaticPrefabs/MG_Main_L7_X0_Y0.prefab	Assets/Product/AssetRef/BigWorld/SkyGarden_JumpPlayer/StaticPrefabs/MG_Main_L7_X0_Y0.asset
Assets/Product/BigWorld/SkyGarden_LxyStoryLevel01/StaticPrefabs/MG_Main_L7_X0_Y0.prefab	Assets/Product/AssetRef/BigWorld/SkyGarden_LxyStoryLevel01/StaticPrefabs/MG_Main_L7_X0_Y0.asset
Assets/Product/BigWorld/SkyGarden/StaticPrefabs/MG_Building_L1_X40_Y36.prefab	Assets/Product/AssetRef/BigWorld/SkyGarden/StaticPrefabs/MG_Building_L1_X40_Y36.asset
Assets/Product/BigWorld/SkyGarden/StaticPrefabs/MG_Main_L1_X80_Y72.prefab	Assets/Product/AssetRef/BigWorld/SkyGarden/StaticPrefabs/MG_Main_L1_X80_Y72.asset
Assets/Product/BigWorld/SkyGarden/StaticPrefabs/MG_Building_L0_X80_Y73.prefab	Assets/Product/AssetRef/BigWorld/SkyGarden/StaticPrefabs/MG_Building_L0_X80_Y73.asset
Assets/Product/BigWorld/SkyGarden/StaticPrefabs/MG_Building_L0_X64_Y64.prefab	Assets/Product/AssetRef/BigWorld/SkyGarden/StaticPrefabs/MG_Building_L0_X64_Y64.asset
Assets/Product/BigWorld/SkyGarden/StaticPrefabs/MG_Tree_L0_X151_Y140.prefab	Assets/Product/AssetRef/BigWorld/SkyGarden/StaticPrefabs/MG_Tree_L0_X151_Y140.asset
Assets/Product/BigWorld/SkyGarden_Plaza/StaticPrefabs/MG_Main_L0_X165_Y146.prefab	Assets/Product/AssetRef/BigWorld/SkyGarden_Plaza/StaticPrefabs/MG_Main_L0_X165_Y146.asset
