ClassType	Path
CharacterEquipQualityCompare	XBehaviourNode/XGuide/XGuideCharacterEquipQualityCompareNode
CheckCharacterEquipWithSiteExist	XBehaviourNode/XGuide/XGuideCharacterEquipWithPosExistNode
GuideCurveDynamicIndex	XBehaviourNode/XGuide/XGuideCurveDynamicIndexNode
GuideDispatchEvent	XBehaviourNode/XGuide/XGuideDispatchEvent
GuideDynamicIndex	XBehaviourNode/XGuide/XGuideDynamicIndexNode
GuideEnd	XBehaviourNode/XGuide/XGuideEndNode
GuideFilterIsFold	XBehaviourNode/XGuide/XGuideFilterIsFold
GuideFilterTagEqual	XBehaviourNode/XGuide/XGuideFilterTagEqual
GuideFixed3DDynamicIndex	XBehaviourNode/XGuide/XGuideFixed3DDynamicIndexNode
GuideFocusOn3D	XBehaviourNode/XGuide/XGuideFocusOn3DNode
GuideFocusOnChild	XBehaviourNode/XGuide/XGuideFocusOnChildNode
GuideFocusOn	XBehaviourNode/XGuide/XGuideFocusOnPanelNode
GuideFocusOnScrollRect	XBehaviourNode/XGuide/XGuideFocusOnScrollRectNode
GuideFocusOnTextExUnderline	XBehaviourNode/XGuide/XGuideFocusOnTextExUnderlineNode
SetActive	XBehaviourNode/XGuide/XGuideFocusSetActive
GuideForceStep	XBehaviourNode/XGuide/XGuideForceStepNode
GuideFubenJumpToStage	XBehaviourNode/XGuide/XGuideFubenJumpToStageNode
GuideHideDialog	XBehaviourNode/XGuide/XGuideHideDialogNode
IsAnimPlaying	XBehaviourNode/XGuide/XGuideIsAnimPlayingNode
GuideIsAnyClick	XBehaviourNode/XGuide/XGuideIsAnyClickNode
IsCharacterInTeam	XBehaviourNode/XGuide/XGuideIsCharacterInTeamNode
IsGameObjectActive	XBehaviourNode/XGuide/XGuideIsGameObjectActiveNode
IsJoinGuild	XBehaviourNode/XGuide/XGuideIsJoinGuildNode
IsUiOpen	XBehaviourNode/XGuide/XGuideIsUiOpenNode
OpenDormitory	XBehaviourNode/XGuide/XGuideOpenDormitoryNode
GuideRecord	XBehaviourNode/XGuide/XGuideRecordNode
GuideShowDialog	XBehaviourNode/XGuide/XGuideShowDialogNode
GuideShowMask	XBehaviourNode/XGuide/XGuideShowMaskNode
GuideIsBlockRayCast	XBehaviourNode/XGuide/XGuideShowMaskNodeNew
GuideStart	XBehaviourNode/XGuide/XGuideStartNode
GuideWaitForDynamicNormalComplete	XBehaviourNode/XGuide/XGuideWaitForDynamicNormalComplete
RestaurantBubbleIndex	XBehaviourNode/XRestaurant/XCharacter/XRestaurantBubbleIndexNode
RestaurantCheckInt	XBehaviourNode/XRestaurant/XCharacter/XRestaurantCheckIntNode
RestaurantDestroyEffect	XBehaviourNode/XRestaurant/XCharacter/XRestaurantDestroyEffectNode
RestaurantDisposeRole	XBehaviourNode/XRestaurant/XCharacter/XRestaurantDisposeRoleNode
RestaurantDoActionIndex	XBehaviourNode/XRestaurant/XCharacter/XRestaurantDoActionIndexNode
RestaurantDoActionIndexOnly	XBehaviourNode/XRestaurant/XCharacter/XRestaurantDoActionIndexOnlyNode
RestaurantDoActionOnly	XBehaviourNode/XRestaurant/XCharacter/XRestaurantDoActionOnlyNode
RestaurantHideBubble	XBehaviourNode/XRestaurant/XCharacter/XRestaurantHideBubbleNode
RestaurantHideEffect	XBehaviourNode/XRestaurant/XCharacter/XRestaurantHideEffectNode
RestaurantIsExist	XBehaviourNode/XRestaurant/XCharacter/XRestaurantIsExistNode
RestaurantIsWorking	XBehaviourNode/XRestaurant/XCharacter/XRestaurantIsWorkingNode
RestaurantIsWorkWithBuff	XBehaviourNode/XRestaurant/XCharacter/XRestaurantIsWorkWithBuffNode
RestaurantLoadComplete	XBehaviourNode/XRestaurant/XCharacter/XRestaurantLoadCompleteNode
RestaurantLoadEffect	XBehaviourNode/XRestaurant/XCharacter/XRestaurantLoadEffectNode
RestaurantRandomBubbleDelay	XBehaviourNode/XRestaurant/XCharacter/XRestaurantRandomBubbleDelayNode
RestaurantRandomBubble	XBehaviourNode/XRestaurant/XCharacter/XRestaurantRandomBubbleNode
RestaurantRandomPath	XBehaviourNode/XRestaurant/XCharacter/XRestaurantRandomPathNode
RestaurantSetGreenPoint	XBehaviourNode/XRestaurant/XCharacter/XRestaurantSetGreenPointNode
RestaurantSetRedPoint	XBehaviourNode/XRestaurant/XCharacter/XRestaurantSetRedPointNode
RestaurantSetStartPoint	XBehaviourNode/XRestaurant/XCharacter/XRestaurantSetStartPointNode
RestaurantStopMove	XBehaviourNode/XRestaurant/XCharacter/XRestaurantStopMoveNode
RestaurantBeginPerform	XBehaviourNode/XRestaurant/XPerformance/XRestaurantBeginPerformNode
RestaurantChangePerformState	XBehaviourNode/XRestaurant/XPerformance/XRestaurantChangePerformStateNode
RestaurantDestroyPerformProps	XBehaviourNode/XRestaurant/XPerformance/XRestaurantDestroyPerformPropsNode
RestaurantDestroyProps	XBehaviourNode/XRestaurant/XPerformance/XRestaurantDestroyPropsNode
RestaurantLoadPerformer	XBehaviourNode/XRestaurant/XPerformance/XRestaurantLoadPerformerNode
RestaurantPerformHideBubble	XBehaviourNode/XRestaurant/XPerformance/XRestaurantPerformHideBubbleNode
RestaurantPerformShowBubble	XBehaviourNode/XRestaurant/XPerformance/XRestaurantPerformShowBubbleNode
RestaurantPerformStateCheck	XBehaviourNode/XRestaurant/XPerformance/XRestaurantPerformStateCheckNode
HomeCharBubble	XBehaviourNode/XHome/XHomeChar/XHomeCharBubbleNode
HomeCharCancelInteractBtnShow	XBehaviourNode/XHome/XHomeChar/XHomeCharCancelInteractBtnShow
HomeCharChangeStateMachine	XBehaviourNode/XHome/XHomeChar/XHomeCharChangeStateMachineNode
HomeCharCheckClick	XBehaviourNode/XHome/XHomeChar/XHomeCharCheckClick
HomeCharCheckDisgusted	XBehaviourNode/XHome/XHomeChar/XHomeCharCheckDisgustedNode
HomeCHarCheckCanDisInteractFurniture	XBehaviourNode/XHome/XHomeChar/XHomeCharCheckDisInteractFurnitureNode
HomeCharCheckEventExist	XBehaviourNode/XHome/XHomeChar/XHomeCharCheckEventExistNode
HomeCharCheckFriend	XBehaviourNode/XHome/XHomeChar/XHomeCharCheckFriendNode
HomeCharCheckInteract	XBehaviourNode/XHome/XHomeChar/XHomeCharCheckInteractNode
HomeCharCheckPetLikeNode	XBehaviourNode/XHome/XHomeChar/XHomeCharCheckPetLikeNode
HomeCharCheckPlayAnimation	XBehaviourNode/XHome/XHomeChar/XHomeCharCheckPlayAnimationNode
HomeCharCheckPointerUp	XBehaviourNode/XHome/XHomeChar/XHomeCharCheckPointerUpNode
HomeCharCheckRayCastFurniture	XBehaviourNode/XHome/XHomeChar/XHomeCharCheckRayCastFurnitureNode
HomeCharCheckRelation	XBehaviourNode/XHome/XHomeChar/XHomeCharCheckRelationNode
HomeCharCompletedFondle	XBehaviourNode/XHome/XHomeChar/XHomeCharCompletedFondleNode
HomeCharDialog	XBehaviourNode/XHome/XHomeChar/XHomeCharDialogNode
HomeCharDoEffect	XBehaviourNode/XHome/XHomeChar/XHomeCharDoEffectNode
HomeCharDoRoleActionOnly	XBehaviourNode/XHome/XHomeChar/XHomeCharDoRoleActionOnlyNode
HomeCharEventReward	XBehaviourNode/XHome/XHomeChar/XHomeCharEventRewardNode
HomeCharEventTypeCompare	XBehaviourNode/XHome/XHomeChar/XHomeCharEventTypeCompareNode
HomeCharFaceLock	XBehaviourNode/XHome/XHomeChar/XHomeCharFaceLockNode
HomeCharFondleTypeJudge	XBehaviourNode/XHome/XHomeChar/XHomeCharFondleTypeJudgeNode
HomeCharForwardToFurniture	XBehaviourNode/XHome/XHomeChar/XHomeCharForwardToFurnitureNode
HomeCharHideBubble	XBehaviourNode/XHome/XHomeChar/XHomeCharHideBubbleNode
HomeCharHideEffect	XBehaviourNode/XHome/XHomeChar/XHomeCharHideEffectNode
HomeCharInteractFunitureAction	XBehaviourNode/XHome/XHomeChar/XHomeCharInteractFunitureActionNode
HomeCharInteract	XBehaviourNode/XHome/XHomeChar/XHomeCharInteractNode
HomeCharInteractStop	XBehaviourNode/XHome/XHomeChar/XHomeCharInteractStop
HomeCharInteractTypeCompare	XBehaviourNode/XHome/XHomeChar/XHomeCharInteractTypeCompareNode
HomeCharIsDirectInteract	XBehaviourNode/XHome/XHomeChar/XHomeCharIsDirectInteract
HomeCharJudgeAttrInt	XBehaviourNode/XHome/XHomeChar/XHomeCharJudgeAttributeNode
HomeCharJudgeInteractPos	XBehaviourNode/XHome/XHomeChar/XHomeCharJudgeInteractPosNode
HomeCharCheckIsCanDestroy	XBehaviourNode/XHome/XHomeChar/XHomeCharNodes
HomeCharObstacleEnable	XBehaviourNode/XHome/XHomeChar/XHomeCharObstacleEnableNode
HomeCharPathFind	XBehaviourNode/XHome/XHomeChar/XHomeCharPathFindNode
HomeCharPlayAlphaAnim	XBehaviourNode/XHome/XHomeChar/XHomeCharPlayAlphaAnim
HomeCharPlayFurnitureAction	XBehaviourNode/XHome/XHomeChar/XHomeCharPlayFurnitureActionNode
HomeCharPlayFurnitureEffect	XBehaviourNode/XHome/XHomeChar/XHomeCharPlayFurnitureEffectNode
HomeCharPlayTalkSystem	XBehaviourNode/XHome/XHomeChar/XHomeCharPlayTalkSystem
HomeCharRandomDialog	XBehaviourNode/XHome/XHomeChar/XHomeCharRandomDialogNode
HomeCharReachFurniture	XBehaviourNode/XHome/XHomeChar/XHomeCharReachFurniture
HomeCharSetCharInteractTrigger	XBehaviourNode/XHome/XHomeChar/XHomeCharSetCharInteractTriggerNode
HomeCharSetInteractOffset	XBehaviourNode/XHome/XHomeChar/XHomeCharSetInteractOffsetNode
HomeCharSetLongPressTrigger	XBehaviourNode/XHome/XHomeChar/XHomeCharSetLongPressTriggerNode
HomeCharSetStayOffest	XBehaviourNode/XHome/XHomeChar/XHomeCharSetStayOffsetNode
HomeCharStateChange	XBehaviourNode/XHome/XHomeChar/XHomeCharStateChangeNode
HomeCharStateCompare	XBehaviourNode/XHome/XHomeChar/XHomeCharStateCompareNode
HomeCharTalkEnd	XBehaviourNode/XHome/XHomeChar/XHomeCharTalkEnd
HomeCharTurnToFurnitureStayPos	XBehaviourNode/XHome/XHomeChar/XHomeCharTurnToFurnitureStayPos
HomeResetCamera	XBehaviourNode/XHome/XHomeChar/XHomeResetCamera
HomeSwitchCamera	XBehaviourNode/XHome/XHomeChar/XHomeSwitchCamera
HomeFurnitureChangeFurniturePosition	XBehaviourNode/XHome/XFurniture/XHomeFurnitureChangeFurniturePositionNode
HomeFurnitureCheckPointerUp	XBehaviourNode/XHome/XFurniture/XHomeFurnitureCheckPointerUpNode
HomeFurnitureCheckRayCastFuniture	XBehaviourNode/XHome/XFurniture/XHomeFurnitureCheckRayCastFunitureNode
HomeFurnitureDoActionOnly	XBehaviourNode/XHome/XFurniture/XHomeFurnitureDoActionOnlyNode
HomeFurnitureDoEffect	XBehaviourNode/XHome/XFurniture/XHomeFurnitureDoEffectNode
HomeFurnitureHide	XBehaviourNode/XHome/XFurniture/XHomeFurnitureHideNode
HomeFurnitureResetFurniturePosition	XBehaviourNode/XHome/XFurniture/XHomeFurnitureResetFurniturePositionNode
HomeFurnitureSaveFurnitureInRoom	XBehaviourNode/XHome/XFurniture/XHomeFurnitureSaveFurnitureInRoomNode
HomeFurnitureSaveSuccess	XBehaviourNode/XHome/XFurniture/XHomeFurnitureSaveSuccessNode
HomeFurnitureSetNameVisible	XBehaviourNode/XHome/XFurniture/XHomeFurnitureSetNameVisibleNode
HomeFurnitureStateChange	XBehaviourNode/XHome/XFurniture/XHomeFurnitureStateChangeNode
GuildDormCheckIsPlayingInstrument	XBehaviourNode/XHome/XGuildDorm/XGuildDormCheckIsPlayingInstrumentNode
GuildDormCheckTime	XBehaviourNode/XHome/XGuildDorm/XGuildDormCheckTimeNode
GuildDormFurnitureHideEffect	XBehaviourNode/XHome/XGuildDorm/XGuildDormFurnitureHideEffectNode
GuildDormFurniturePlayEffect	XBehaviourNode/XHome/XGuildDorm/XGuildDormFurniturePlayEffectNode
GuildDormNpcForwardToPlayer	XBehaviourNode/XHome/XGuildDorm/XGuildDormNpcForwardToPlayerNode
GuildDormNpcTurnToInitPos	XBehaviourNode/XHome/XGuildDorm/XGuildDormNpcTurnToInitPosNode
GuildDormOpenInstrumentUiByFurnitureId	XBehaviourNode/XHome/XGuildDorm/XGuildDormOpenInstrumentUiByFurnitureIdNode
GuildDormResetCameraParam	XBehaviourNode/XHome/XGuildDorm/XGuildDormResetCameraParamNode
GuildDormSetCameraByFurnitureGameObject	XBehaviourNode/XHome/XGuildDorm/XGuildDormSetCameraByFurnitureGameObjectNode
GuildDormSetCameraParam	XBehaviourNode/XHome/XGuildDorm/XGuildDormSetCameraParamNode
